jenner001-2010.png, 1231, 1444, 2675, 0.0994392523364, 2, -1
jenner002-2010.png, 1183, 1562, 2745, 0.114389799636, 2, -1
jenner003-2010.png, 2099, 2319, 4418, 0.0565866908103, 2, -1
jenner004-2010.png, 1352, 1704, 3056, 0.0647905759162, 2, -1
jenner005-2010.png, 1547, 2345, 3892, 0.0256937307297, 2, -1
jenner006-2010.png, 1627, 2170, 3797, 0.206478799052, 2, -1
jenner007-2010.png, 1446, 2109, 3555, 0.189592123769, 2, -1
jenner008-2010.png, 2279, 3059, 5338, 0.152491569876, 2, -1
jenner009-2010.png, 918, 1332, 2250, 0.157333333333, 2, -1
jenner010-2010.png, 1221, 1803, 3024, 0.0337301587302, 2, -1
jenner011-2010.png, 1481, 1335, 2816, 0.0319602272727, 2, -1
jenner012-2010.png, 1867, 2239, 4106, 0.114953726254, 2, -1
jenner013-2010.png, 2173, 2827, 5000, 0.0692, 2, -1
jenner014-2010.png, 2013, 2285, 4298, 0.0697999069335, 2, -1
jenner015-2010.png, 1136, 1532, 2668, 0.117691154423, 2, -1
jenner016-2010.png, 1657, 1970, 3627, 0.106975461814, 2, -1
jenner017-2010.png, 1787, 1639, 3426, 0.113251605371, 2, -1
jenner018-2010.png, 1618, 2356, 3974, 0.0986411675893, 2, -1
jenner019-2010.png, 2141, 1969, 4110, 0.0150851581509, 2, -1
jenner020-2010.png, 1141, 1477, 2618, 0.096256684492, 2, -1
jenner021-2010.png, 1786, 2648, 4434, 0.0676589986468, 2, -1
jenner022-2010.png, 1876, 1939, 3815, 0.0854521625164, 2, -1
jenner023-2010.png, 1183, 1441, 2624, 0.160823170732, 2, -1
jenner024-2010.png, 1701, 2250, 3951, 0.163502910656, 2, -1
jenner025-2010.png, 2639, 3077, 5716, 0.193841847446, 2, -1
jenner026-2010.png, 1577, 2536, 4113, 0.0539752005835, 2, -1
jenner027-2010.png, 2675, 2619, 5294, 0.0710238005289, 2, -1
jenner028-2010.png, 807, 1018, 1825, 0.0493150684932, 2, -1
jenner029-2010.png, 2074, 3076, 5150, 0.120776699029, 2, -1
jenner030-2010.png, 1621, 2334, 3955, 0.134007585335, 2, -1
jenner031-2010.png, 1415, 2181, 3596, 0.141824249166, 2, -1
jenner032-2010.png, 1995, 2388, 4383, 0.126397444673, 2, -1
jenner033-2010.png, 1917, 2353, 4270, 0.16018735363, 2, -1
jenner034-2010.png, 1984, 2752, 4736, 0.0561655405405, 2, -1
jenner035-2010.png, 2584, 2706, 5290, 0.0710775047259, 2, -1
jenner036-2010.png, 1156, 1426, 2582, 0.127033307514, 2, -1
jenner037-2010.png, 1530, 2502, 4032, 0.10119047619, 2, -1
jenner038-2010.png, 1356, 1945, 3301, 0.117540139352, 2, -1
jenner039-2010.png, 696, 1080, 1776, 0.0990990990991, 2, -1
jenner040-2010.png, 1409, 1624, 3033, 0.0784701615562, 2, -1
jenner041-2010.png, 1714, 2638, 4352, 0.0932904411765, 2, -1
jenner042-2010.png, 2330, 3287, 5617, 0.094000356062, 2, -1
jenner043-2010.png, 1837, 2104, 3941, 0.108601877696, 2, -1
jenner044-2010.png, 1252, 1622, 2874, 0.150313152401, 2, -1
jenner045-2010.png, 1716, 2609, 4325, 0.091098265896, 2, -1
jenner046-2010.png, 1451, 2089, 3540, 0.206779661017, 2, -1
jenner047-2010.png, 1014, 1515, 2529, 0.137603795967, 2, -1
jenner048-2010.png, 1846, 2204, 4050, 0.116543209877, 2, -1
jenner049-2010.png, 1557, 2156, 3713, 0.126582278481, 2, -1
jenner050-2010.png, 1402, 2452, 3854, 0.110015568241, 2, -1
jenner051-2010.png, 1574, 1691, 3265, 0.0869831546708, 2, -1
jenner052-2010.png, 1055, 1464, 2519, 0.189757840413, 2, -1
jenner053-2010.png, 1217, 2040, 3257, 0.103776481425, 2, -1
jenner054-2010.png, 973, 1232, 2205, 0.12335600907, 2, -1
jenner055-2010.png, 873, 1112, 1985, 0.166246851385, 2, -1
jenner056-2010.png, 1274, 1235, 2509, 0.0805101634117, 2, -1
jenner057-2010.png, 1669, 2118, 3787, 0.168471085292, 2, -1
jenner058-2010.png, 1323, 2490, 3813, 0.140571728298, 2, -1
jenner059-2010.png, 1574, 1846, 3420, 0.12865497076, 2, -1
jenner060-2010.png, 802, 1118, 1920, 0.0697916666667, 2, -1
jenner061-2010.png, 825, 1575, 2400, 0.0433333333333, 2, -1
jenner062-2010.png, 694, 852, 1546, 0.135834411384, 2, -1
jenner063-2010.png, 1019, 1445, 2464, 0.161525974026, 2, -1
jenner064-2010.png, 1339, 1389, 2728, 0.0982404692082, 2, -1
losangeles001-2010.png, 2652, 3887, 6539, 0.0510781465056, 2, -1
losangeles002-2010.png, 3483, 5272, 8755, 0.0996002284409, 2, -1
losangeles003-2010.png, 1543, 4002, 5545, 0.138503155996, 2, -1
losangeles004-2010.png, 859, 3242, 4101, 0.0687637161668, 2, -1
losangeles005-2010.png, 1553, 3940, 5493, 0.134716912434, 2, -1
losangeles006-2010.png, 2221, 4441, 6662, 0.148303812669, 2, -1
losangeles007-2010.png, 2574, 4033, 6607, 0.242167398214, 2, -1
losangeles008-2010.png, 2523, 4400, 6923, 0.19760219558, 2, -1
losangeles009-2010.png, 2991, 4928, 7919, 0.0396514711453, 2, -1
losangeles010-2010.png, 3131, 4900, 8031, 0.141700908978, 2, -1
losangeles011-2010.png, 2256, 4714, 6970, 0.19856527977, 2, -1
losangeles012-2010.png, 1949, 3447, 5396, 0.170496664196, 2, -1
losangeles013-2010.png, 2156, 4206, 6362, 0.16409933983, 2, -1
losangeles014-2010.png, 3267, 4918, 8185, 0.210873549175, 2, -1
losangeles015-2010.png, 1268, 3012, 4280, 0.177570093458, 2, -1
losangeles016-2010.png, 2223, 4318, 6541, 0.188656168782, 2, -1
losangeles017-2010.png, 3041, 4339, 7380, 0.0509485094851, 2, -1
losangeles018-2010.png, 3006, 3988, 6994, 0.18530168716, 2, -1
losangeles019-2010.png, 1602, 3494, 5096, 0.171899529042, 2, -1
losangeles020-2010.png, 2064, 3761, 5825, 0.196051502146, 2, -1
losangeles021-2010.png, 2047, 3487, 5534, 0.138417058186, 2, -1
losangeles022-2010.png, 2921, 4660, 7581, 0.1899485556, 2, -1
losangeles023-2010.png, 2287, 4216, 6503, 0.21067199754, 2, -1
losangeles024-2010.png, 3000, 4667, 7667, 0.212860310421, 2, -1
losangeles025-2010.png, 2780, 4262, 7042, 0.0454416358989, 2, -1
losangeles026-2010.png, 3032, 4477, 7509, 0.137168730856, 2, -1
losangeles027-2010.png, 1900, 3756, 5656, 0.196958981612, 2, -1
losangeles028-2010.png, 1906, 3437, 5343, 0.208122777466, 2, -1
losangeles029-2010.png, 2505, 3428, 5933, 0.171582673184, 2, -1
losangeles030-2010.png, 2826, 4570, 7396, 0.183071930773, 2, -1
losangeles031-2010.png, 2801, 4265, 7066, 0.236909142372, 2, -1
losangeles032-2010.png, 2842, 4524, 7366, 0.208797176215, 2, -1
losangeles033-2010.png, 3208, 4557, 7765, 0.054603992273, 2, -1
losangeles034-2010.png, 3517, 4684, 8201, 0.067552737471, 2, -1
losangeles035-2010.png, 1880, 4075, 5955, 0.173635600336, 2, -1
losangeles036-2010.png, 2171, 4057, 6228, 0.176621708414, 2, -1
losangeles037-2010.png, 2257, 4127, 6384, 0.161967418546, 2, -1
losangeles038-2010.png, 2689, 4340, 7029, 0.192061459667, 2, -1
losangeles039-2010.png, 2771, 4325, 7096, 0.239289740699, 2, -1
losangeles040-2010.png, 2889, 4516, 7405, 0.209588116138, 2, -1
losangeles041-2010.png, 3702, 4877, 8579, 0.0449935889964, 2, -1
losangeles042-2010.png, 3358, 4090, 7448, 0.131310418904, 2, -1
losangeles043-2010.png, 1671, 3389, 5060, 0.148616600791, 2, -1
losangeles044-2010.png, 2012, 3852, 5864, 0.152796725784, 2, -1
losangeles045-2010.png, 2529, 4177, 6706, 0.137787056367, 2, -1
losangeles046-2010.png, 2665, 4088, 6753, 0.183029764549, 2, -1
losangeles047-2010.png, 2694, 4113, 6807, 0.25091817247, 2, -1
losangeles048-2010.png, 2586, 4387, 6973, 0.198479850853, 2, -1
losangeles049-2010.png, 3307, 4363, 7670, 0.0378096479791, 2, -1
losangeles050-2010.png, 3247, 4106, 7353, 0.170270637835, 2, -1
losangeles051-2010.png, 2414, 4105, 6519, 0.15247737383, 2, -1
losangeles052-2010.png, 2612, 4296, 6908, 0.160683265779, 2, -1
losangeles053-2010.png, 2787, 4052, 6839, 0.173124725837, 2, -1
losangeles054-2010.png, 3211, 4604, 7815, 0.202431222009, 2, -1
losangeles055-2010.png, 2787, 4238, 7025, 0.261067615658, 2, -1
losangeles056-2010.png, 2536, 3893, 6429, 0.183232228963, 2, -1
losangeles057-2010.png, 3192, 4368, 7560, 0.0481481481481, 2, -1
losangeles058-2010.png, 3250, 4647, 7897, 0.124604280106, 2, -1
losangeles059-2010.png, 2553, 4739, 7292, 0.127811300055, 2, -1
losangeles060-2010.png, 3223, 4841, 8064, 0.204861111111, 2, -1
losangeles061-2010.png, 2890, 4220, 7110, 0.181153305204, 2, -1
losangeles062-2010.png, 3131, 4542, 7673, 0.190277596768, 2, -1
losangeles063-2010.png, 2506, 4205, 6711, 0.219341379824, 2, -1
losangeles064-2010.png, 2963, 4401, 7364, 0.182509505703, 2, -1
merced001-2010.png, 3614, 4717, 8331, 0.0861841315568, 2, -1
merced002-2010.png, 3585, 4355, 7940, 0.0239294710327, 2, -1
merced003-2010.png, 866, 1387, 2253, 0.0727918331114, 2, -1
merced004-2010.png, 1039, 1357, 2396, 0.142737896494, 2, -1
merced005-2010.png, 597, 734, 1331, 0.135236664162, 2, -1
merced006-2010.png, 360, 637, 997, 0.0481444332999, 2, -1
merced007-2010.png, 291, 504, 795, 0.0176100628931, 2, -1
merced008-2010.png, 239, 227, 466, 0.0557939914163, 2, -1
merced009-2010.png, 2814, 4533, 7347, 0.0792160065333, 2, -1
merced010-2010.png, 2709, 4229, 6938, 0.0389161141539, 2, -1
merced011-2010.png, 675, 964, 1639, 0.0402684563758, 2, -1
merced012-2010.png, 881, 1129, 2010, 0.107462686567, 2, -1
merced013-2010.png, 603, 621, 1224, 0.0392156862745, 2, -1
merced014-2010.png, 823, 1493, 2316, 0.0613126079447, 2, -1
merced015-2010.png, 419, 1038, 1457, 0.0947151681537, 2, -1
merced016-2010.png, 550, 767, 1317, 0.126044039484, 2, -1
merced017-2010.png, 1047, 2001, 3048, 0.0702099737533, 2, -1
merced018-2010.png, 1128, 1834, 2962, 0.0351114112086, 2, -1
merced019-2010.png, 551, 690, 1241, 0.0225624496374, 2, -1
merced020-2010.png, 432, 405, 837, 0.0812425328554, 2, -1
merced021-2010.png, 758, 274, 1032, 0.00968992248062, 2, -1
merced022-2010.png, 796, 359, 1155, 0.0484848484848, 2, -1
merced023-2010.png, 452, 578, 1030, 0.0718446601942, 2, -1
merced024-2010.png, 149, 500, 649, 0.0431432973806, 2, -1
merced025-2010.png, 611, 1318, 1929, 0.0528771384137, 2, -1
merced026-2010.png, 1003, 1194, 2197, 0.0509786071916, 2, -1
merced027-2010.png, 1030, 1011, 2041, 0.0362567368937, 2, -1
merced028-2010.png, 640, 252, 892, 0.0112107623318, 2, -1
merced029-2010.png, 1684, 112, 1796, 0.0100222717149, 2, -1
merced030-2010.png, 1582, 98, 1680, 0.00119047619048, 2, -1
merced031-2010.png, 481, 670, 1151, 0.0799304952215, 2, -1
merced032-2010.png, 269, 356, 625, 0.0288, 2, -1
merced033-2010.png, 1256, 1512, 2768, 0.171242774566, 2, -1
merced034-2010.png, 935, 1218, 2153, 0.0315838365072, 2, -1
merced035-2010.png, 626, 375, 1001, 0.0539460539461, 2, -1
merced036-2010.png, 1367, 490, 1857, 0.082929456112, 2, -1
merced037-2010.png, 2973, 968, 3941, 0.088809946714, 2, -1
merced038-2010.png, 1850, 186, 2036, 0.0196463654224, 2, -1
merced039-2010.png, 784, 472, 1256, 0.0812101910828, 2, -1
merced040-2010.png, 438, 352, 790, 0.0379746835443, 2, -1
merced041-2010.png, 1033, 1113, 2146, 0.151910531221, 2, -1
merced042-2010.png, 1031, 599, 1630, 0.0331288343558, 2, -1
merced043-2010.png, 1092, 158, 1250, 0.0352, 2, -1
merced044-2010.png, 1433, 291, 1724, 0.0243619489559, 2, -1
merced045-2010.png, 3179, 746, 3925, 0.071847133758, 2, -1
merced046-2010.png, 2300, 284, 2584, 0.03173374613, 2, -1
merced047-2010.png, 916, 754, 1670, 0.152095808383, 2, -1
merced048-2010.png, 916, 1210, 2126, 0.0169332079022, 2, -1
merced049-2010.png, 351, 627, 978, 0.0920245398773, 2, -1
merced050-2010.png, 563, 248, 811, 0.103575832306, 2, -1
merced051-2010.png, 1085, 213, 1298, 0.0261941448382, 2, -1
merced052-2010.png, 2085, 186, 2271, 0.0114487010128, 2, -1
merced053-2010.png, 2232, 193, 2425, 0.0164948453608, 2, -1
merced054-2010.png, 1796, 115, 1911, 0.00732600732601, 2, -1
merced055-2010.png, 488, 329, 817, 0.093023255814, 2, -1
merced056-2010.png, 502, 681, 1183, 0.0050718512257, 2, -1
merced057-2010.png, 477, 226, 703, 0.0170697012802, 2, -1
merced058-2010.png, 440, 32, 472, 0.0423728813559, 2, -1
merced059-2010.png, 655, 203, 858, 0.0536130536131, 2, -1
merced060-2010.png, 1006, 157, 1163, 0.0189165950129, 2, -1
merced061-2010.png, 898, 436, 1334, 0.023988005997, 2, -1
merced062-2010.png, 1459, 270, 1729, 0.0289184499711, 2, -1
merced063-2010.png, 1310, 317, 1627, 0.0221266133989, 2, -1
merced064-2010.png, 964, 643, 1607, 0.0149346608587, 2, -1
oakland001-2010.png, 2989, 3138, 6127, 0.0505957238453, 2, -1
oakland002-2010.png, 3766, 3458, 7224, 0.062015503876, 2, -1
oakland003-2010.png, 3959, 4543, 8502, 0.107974594213, 2, -1
oakland004-2010.png, 3764, 4701, 8465, 0.108446544595, 2, -1
oakland005-2010.png, 3288, 3700, 6988, 0.103319977104, 2, -1
oakland006-2010.png, 1843, 1707, 3550, 0.0535211267606, 2, -1
oakland007-2010.png, 1333, 2282, 3615, 0.173720608575, 2, -1
oakland008-2010.png, 1334, 2175, 3509, 0.273582217156, 2, -1
oakland009-2010.png, 2242, 2408, 4650, 0.0391397849462, 2, -1
oakland010-2010.png, 3436, 4128, 7564, 0.0928080380751, 2, -1
oakland011-2010.png, 3339, 4512, 7851, 0.0486562221373, 2, -1
oakland012-2010.png, 3637, 4623, 8260, 0.0421307506053, 2, -1
oakland013-2010.png, 2815, 2466, 5281, 0.0106040522628, 2, -1
oakland014-2010.png, 1872, 2003, 3875, 0.0614193548387, 2, -1
oakland015-2010.png, 2309, 3482, 5791, 0.160248661716, 2, -1
oakland016-2010.png, 1308, 2239, 3547, 0.173667888356, 2, -1
oakland017-2010.png, 2584, 2835, 5419, 0.0461339730578, 2, -1
oakland018-2010.png, 3244, 4412, 7656, 0.104493207941, 2, -1
oakland019-2010.png, 3565, 4477, 8042, 0.0793334991296, 2, -1
oakland020-2010.png, 3304, 4192, 7496, 0.0320170757737, 2, -1
oakland021-2010.png, 2134, 2743, 4877, 0.0668443715399, 2, -1
oakland022-2010.png, 3899, 4671, 8570, 0.101983663944, 2, -1
oakland023-2010.png, 3172, 4414, 7586, 0.176904824677, 2, -1
oakland024-2010.png, 1401, 2412, 3813, 0.161028061894, 2, -1
oakland025-2010.png, 3430, 3866, 7296, 0.0455043859649, 2, -1
oakland026-2010.png, 4027, 4627, 8654, 0.108851398197, 2, -1
oakland027-2010.png, 2772, 3386, 6158, 0.0503410198116, 2, -1
oakland028-2010.png, 2167, 2671, 4838, 0.0566349731294, 2, -1
oakland029-2010.png, 3239, 4225, 7464, 0.0793140407288, 2, -1
oakland030-2010.png, 3254, 4182, 7436, 0.122646584185, 2, -1
oakland031-2010.png, 1321, 2602, 3923, 0.143767524853, 2, -1
oakland032-2010.png, 3537, 4940, 8477, 0.211867405922, 2, -1
oakland033-2010.png, 3634, 4319, 7953, 0.0507984408399, 2, -1
oakland034-2010.png, 3519, 5195, 8714, 0.0764287353684, 2, -1
oakland035-2010.png, 3092, 3315, 6407, 0.0611830810052, 2, -1
oakland036-2010.png, 2712, 3483, 6195, 0.0519774011299, 2, -1
oakland037-2010.png, 3748, 4846, 8594, 0.109844077263, 2, -1
oakland038-2010.png, 2501, 3545, 6046, 0.127687727423, 2, -1
oakland039-2010.png, 3403, 4958, 8361, 0.216959693817, 2, -1
oakland040-2010.png, 3821, 5340, 9161, 0.249099443292, 2, -1
oakland041-2010.png, 3164, 4331, 7495, 0.0565710473649, 2, -1
oakland042-2010.png, 2940, 3654, 6594, 0.0485289657264, 2, -1
oakland043-2010.png, 2594, 2647, 5241, 0.112573936272, 2, -1
oakland044-2010.png, 2818, 3468, 6286, 0.100859051861, 2, -1
oakland045-2010.png, 3709, 4921, 8630, 0.0887601390498, 2, -1
oakland046-2010.png, 3168, 4192, 7360, 0.0896739130435, 2, -1
oakland047-2010.png, 2838, 4199, 7037, 0.19525365923, 2, -1
oakland048-2010.png, 3205, 4888, 8093, 0.222167305078, 2, -1
oakland049-2010.png, 3579, 3883, 7462, 0.0463682658805, 2, -1
oakland050-2010.png, 1630, 2204, 3834, 0.0438184663537, 2, -1
oakland051-2010.png, 1742, 2075, 3817, 0.0723080953629, 2, -1
oakland052-2010.png, 1326, 1844, 3170, 0.0738170347003, 2, -1
oakland053-2010.png, 2159, 2586, 4745, 0.0939936775553, 2, -1
oakland054-2010.png, 1849, 2493, 4342, 0.0898203592814, 2, -1
oakland055-2010.png, 3001, 4104, 7105, 0.224349049965, 2, -1
oakland056-2010.png, 3496, 5191, 8687, 0.241280073673, 2, -1
oakland057-2010.png, 1404, 1753, 3157, 0.0335761799176, 2, -1
oakland058-2010.png, 2431, 2386, 4817, 0.0406892256591, 2, -1
oakland059-2010.png, 2031, 2070, 4101, 0.0629114850037, 2, -1
oakland060-2010.png, 2257, 2556, 4813, 0.0685643050073, 2, -1
oakland061-2010.png, 2099, 3130, 5229, 0.0845285905527, 2, -1
oakland062-2010.png, 1334, 2235, 3569, 0.109834687588, 2, -1
oakland063-2010.png, 2221, 3204, 5425, 0.19797235023, 2, -1
oakland064-2010.png, 4014, 5421, 9435, 0.222787493376, 2, -1
petaluma001-2010.png, 1518, 2032, 3550, 0.229295774648, 2, -1
petaluma002-2010.png, 3415, 4385, 7800, 0.25, 2, -1
petaluma003-2010.png, 1406, 2487, 3893, 0.126380683278, 2, -1
petaluma004-2010.png, 1390, 1657, 3047, 0.057761732852, 2, -1
petaluma005-2010.png, 1123, 1444, 2567, 0.032723022984, 2, -1
petaluma006-2010.png, 718, 947, 1665, 0.0396396396396, 2, -1
petaluma007-2010.png, 1610, 2162, 3772, 0.084835630965, 2, -1
petaluma008-2010.png, 1232, 2043, 3275, 0.0574045801527, 2, -1
petaluma009-2010.png, 3565, 4461, 8026, 0.244455519561, 2, -1
petaluma010-2010.png, 2965, 3831, 6796, 0.242789876398, 2, -1
petaluma011-2010.png, 2666, 3794, 6460, 0.16439628483, 2, -1
petaluma012-2010.png, 779, 1512, 2291, 0.0323003055434, 2, -1
petaluma013-2010.png, 798, 1501, 2299, 0.0121792083515, 2, -1
petaluma014-2010.png, 1345, 1961, 3306, 0.0635208711434, 2, -1
petaluma015-2010.png, 952, 1561, 2513, 0.109033028253, 2, -1
petaluma016-2010.png, 1339, 1820, 3159, 0.076606521051, 2, -1
petaluma017-2010.png, 3437, 4567, 8004, 0.174412793603, 2, -1
petaluma018-2010.png, 3397, 4381, 7778, 0.163795320134, 2, -1
petaluma019-2010.png, 2056, 3195, 5251, 0.134450580842, 2, -1
petaluma020-2010.png, 1478, 1982, 3460, 0.0699421965318, 2, -1
petaluma021-2010.png, 1517, 1790, 3307, 0.0931357726036, 2, -1
petaluma022-2010.png, 2163, 2846, 5009, 0.176881613096, 2, -1
petaluma023-2010.png, 1679, 2263, 3942, 0.0842212075089, 2, -1
petaluma024-2010.png, 1921, 2616, 4537, 0.080229226361, 2, -1
petaluma025-2010.png, 2577, 3550, 6127, 0.163538436429, 2, -1
petaluma026-2010.png, 1689, 2616, 4305, 0.108710801394, 2, -1
petaluma027-2010.png, 1227, 1649, 2876, 0.101529902643, 2, -1
petaluma028-2010.png, 1489, 2067, 3556, 0.0584926884139, 2, -1
petaluma029-2010.png, 1835, 2455, 4290, 0.126806526807, 2, -1
petaluma030-2010.png, 1688, 2296, 3984, 0.171184738956, 2, -1
petaluma031-2010.png, 1246, 1883, 3129, 0.0524129114733, 2, -1
petaluma032-2010.png, 2711, 3610, 6321, 0.0480936560671, 2, -1
petaluma033-2010.png, 2593, 3051, 5644, 0.128277817151, 2, -1
petaluma034-2010.png, 1164, 1613, 2777, 0.0950666186532, 2, -1
petaluma035-2010.png, 1790, 2128, 3918, 0.0908626850434, 2, -1
petaluma036-2010.png, 1683, 2593, 4276, 0.0491113189897, 2, -1
petaluma037-2010.png, 2840, 3505, 6345, 0.14342001576, 2, -1
petaluma038-2010.png, 2642, 3573, 6215, 0.15768302494, 2, -1
petaluma039-2010.png, 3455, 4503, 7958, 0.0630811761749, 2, -1
petaluma040-2010.png, 3066, 4054, 7120, 0.073595505618, 2, -1
petaluma041-2010.png, 1303, 1948, 3251, 0.110119963088, 2, -1
petaluma042-2010.png, 1729, 2453, 4182, 0.16068866571, 2, -1
petaluma043-2010.png, 1986, 2923, 4909, 0.144224893054, 2, -1
petaluma044-2010.png, 2176, 3125, 5301, 0.0890398038106, 2, -1
petaluma045-2010.png, 2082, 2531, 4613, 0.107522219814, 2, -1
petaluma046-2010.png, 2552, 3426, 5978, 0.109066577451, 2, -1
petaluma047-2010.png, 3885, 5064, 8949, 0.104369203263, 2, -1
petaluma048-2010.png, 1811, 2659, 4470, 0.147651006711, 2, -1
petaluma049-2010.png, 2021, 2825, 4846, 0.132893107718, 2, -1
petaluma050-2010.png, 2065, 2953, 5018, 0.138700677561, 2, -1
petaluma051-2010.png, 2080, 2924, 5004, 0.171862509992, 2, -1
petaluma052-2010.png, 1628, 2206, 3834, 0.0636411058946, 2, -1
petaluma053-2010.png, 1571, 1428, 2999, 0.0366788929643, 2, -1
petaluma054-2010.png, 2505, 3392, 5897, 0.0858063422079, 2, -1
petaluma055-2010.png, 2539, 3373, 5912, 0.162043301759, 2, -1
petaluma056-2010.png, 2041, 2862, 4903, 0.136243116459, 2, -1
petaluma057-2010.png, 952, 1376, 2328, 0.103951890034, 2, -1
petaluma058-2010.png, 2040, 2887, 4927, 0.139232798863, 2, -1
petaluma059-2010.png, 1916, 2948, 4864, 0.140213815789, 2, -1
petaluma060-2010.png, 1321, 1484, 2805, 0.0606060606061, 2, -1
petaluma061-2010.png, 2235, 2453, 4688, 0.0648464163823, 2, -1
petaluma062-2010.png, 2852, 3838, 6690, 0.0932735426009, 2, -1
petaluma063-2010.png, 1573, 1679, 3252, 0.113161131611, 2, -1
petaluma064-2010.png, 1714, 2169, 3883, 0.163790883338, 2, -1
sanjose001-2010.png, 4089, 4742, 8831, 0.0541275053788, 2, -1
sanjose002-2010.png, 3843, 4453, 8296, 0.0597878495661, 2, -1
sanjose003-2010.png, 3427, 4393, 7820, 0.0613810741688, 2, -1
sanjose004-2010.png, 2783, 3433, 6216, 0.127413127413, 2, -1
sanjose005-2010.png, 3464, 4760, 8224, 0.100924124514, 2, -1
sanjose006-2010.png, 3075, 4312, 7387, 0.188439149858, 2, -1
sanjose007-2010.png, 2895, 3941, 6836, 0.206553540082, 2, -1
sanjose008-2010.png, 1147, 2234, 3381, 0.212954747116, 2, -1
sanjose009-2010.png, 3784, 4763, 8547, 0.038844038844, 2, -1
sanjose010-2010.png, 3486, 4553, 8039, 0.0460256250777, 2, -1
sanjose011-2010.png, 4003, 4493, 8496, 0.0527306967985, 2, -1
sanjose012-2010.png, 2850, 3896, 6746, 0.0889415950193, 2, -1
sanjose013-2010.png, 2897, 3797, 6694, 0.0932178069913, 2, -1
sanjose014-2010.png, 2972, 4039, 7011, 0.146911995436, 2, -1
sanjose015-2010.png, 2593, 3407, 6000, 0.162333333333, 2, -1
sanjose016-2010.png, 1526, 2923, 4449, 0.164531355361, 2, -1
sanjose017-2010.png, 3556, 4285, 7841, 0.0397908430047, 2, -1
sanjose018-2010.png, 2410, 3050, 5460, 0.0769230769231, 2, -1
sanjose019-2010.png, 2999, 4055, 7054, 0.0510348738305, 2, -1
sanjose020-2010.png, 2843, 3908, 6751, 0.0903569841505, 2, -1
sanjose021-2010.png, 3125, 4461, 7586, 0.100711837596, 2, -1
sanjose022-2010.png, 3029, 3823, 6852, 0.178925861062, 2, -1
sanjose023-2010.png, 1215, 1776, 2991, 0.165830825811, 2, -1
sanjose024-2010.png, 1019, 2247, 3266, 0.110226576852, 2, -1
sanjose025-2010.png, 2756, 3204, 5960, 0.0865771812081, 2, -1
sanjose026-2010.png, 3509, 3989, 7498, 0.0840224059749, 2, -1
sanjose027-2010.png, 3107, 3595, 6702, 0.0999701581617, 2, -1
sanjose028-2010.png, 3523, 4455, 7978, 0.135372273753, 2, -1
sanjose029-2010.png, 3476, 4812, 8288, 0.115106177606, 2, -1
sanjose030-2010.png, 2190, 2933, 5123, 0.17958227601, 2, -1
sanjose031-2010.png, 1781, 2446, 4227, 0.210551218358, 2, -1
sanjose032-2010.png, 1512, 3203, 4715, 0.174761399788, 2, -1
sanjose033-2010.png, 3542, 4048, 7590, 0.0450592885375, 2, -1
sanjose034-2010.png, 3586, 3914, 7500, 0.0984, 2, -1
sanjose035-2010.png, 3347, 4015, 7362, 0.104047813094, 2, -1
sanjose036-2010.png, 3005, 4109, 7114, 0.110767500703, 2, -1
sanjose037-2010.png, 3244, 4800, 8044, 0.132272501243, 2, -1
sanjose038-2010.png, 1161, 1945, 3106, 0.254346426272, 2, -1
sanjose039-2010.png, 1406, 2189, 3595, 0.204172461752, 2, -1
sanjose040-2010.png, 2178, 3845, 6023, 0.179644695335, 2, -1
sanjose041-2010.png, 3267, 3635, 6902, 0.0463633729354, 2, -1
sanjose042-2010.png, 2688, 3498, 6186, 0.0911736178468, 2, -1
sanjose043-2010.png, 3047, 3599, 6646, 0.133313271141, 2, -1
sanjose044-2010.png, 3155, 3948, 7103, 0.102210333662, 2, -1
sanjose045-2010.png, 1081, 1723, 2804, 0.0499286733238, 2, -1
sanjose046-2010.png, 730, 1526, 2256, 0.19414893617, 2, -1
sanjose047-2010.png, 1653, 2715, 4368, 0.204212454212, 2, -1
sanjose048-2010.png, 2316, 4241, 6557, 0.180570382797, 2, -1
sanjose049-2010.png, 1880, 2568, 4448, 0.0476618705036, 2, -1
sanjose050-2010.png, 2725, 3625, 6350, 0.0548031496063, 2, -1
sanjose051-2010.png, 3372, 4098, 7470, 0.101472556894, 2, -1
sanjose052-2010.png, 1087, 1533, 2620, 0.0992366412214, 2, -1
sanjose053-2010.png, 857, 1452, 2309, 0.0926808142053, 2, -1
sanjose054-2010.png, 1426, 2007, 3433, 0.2394407224, 2, -1
sanjose055-2010.png, 1708, 2702, 4410, 0.202721088435, 2, -1
sanjose056-2010.png, 1700, 2766, 4466, 0.20420958352, 2, -1
sanjose057-2010.png, 1056, 1594, 2650, 0.0656603773585, 2, -1
sanjose058-2010.png, 2569, 3857, 6426, 0.088079676315, 2, -1
sanjose059-2010.png, 2177, 3161, 5338, 0.0801798426377, 2, -1
sanjose060-2010.png, 1604, 2243, 3847, 0.0493891343904, 2, -1
sanjose061-2010.png, 633, 1716, 2349, 0.0340570455513, 2, -1
sanjose062-2010.png, 855, 2158, 3013, 0.210421506804, 2, -1
sanjose063-2010.png, 1720, 2594, 4314, 0.231339823829, 2, -1
sanjose064-2010.png, 1608, 3058, 4666, 0.258894127733, 2, -1
sanysidro001-2010.png, 2929, 3887, 6816, 0.145833333333, 2, -1
sanysidro002-2010.png, 3351, 3915, 7266, 0.139829342141, 2, -1
sanysidro003-2010.png, 2731, 3602, 6333, 0.0574767093005, 2, -1
sanysidro004-2010.png, 1731, 2318, 4049, 0.0691528772536, 2, -1
sanysidro005-2010.png, 1283, 1560, 2843, 0.0773830460781, 2, -1
sanysidro006-2010.png, 666, 1372, 2038, 0.045142296369, 2, -1
sanysidro007-2010.png, 598, 1384, 1982, 0.0393541876892, 2, -1
sanysidro008-2010.png, 727, 1467, 2194, 0.148587055606, 2, -1
sanysidro009-2010.png, 2095, 2751, 4846, 0.181593066447, 2, -1
sanysidro010-2010.png, 3881, 4405, 8286, 0.153270576877, 2, -1
sanysidro011-2010.png, 2877, 3867, 6744, 0.0622775800712, 2, -1
sanysidro012-2010.png, 1634, 1958, 3592, 0.0534521158129, 2, -1
sanysidro013-2010.png, 558, 698, 1256, 0.0796178343949, 2, -1
sanysidro014-2010.png, 808, 1888, 2696, 0.0697329376855, 2, -1
sanysidro015-2010.png, 180, 834, 1014, 0.00986193293886, 2, -1
sanysidro016-2010.png, 291, 1649, 1940, 0.0814432989691, 2, -1
sanysidro017-2010.png, 3045, 3530, 6575, 0.171254752852, 2, -1
sanysidro018-2010.png, 4127, 4821, 8948, 0.1119803308, 2, -1
sanysidro019-2010.png, 3574, 4596, 8170, 0.065605875153, 2, -1
sanysidro020-2010.png, 2980, 3542, 6522, 0.0539711744864, 2, -1
sanysidro021-2010.png, 2035, 2809, 4844, 0.0499587118084, 2, -1
sanysidro022-2010.png, 1085, 2054, 3139, 0.0713603058299, 2, -1
sanysidro023-2010.png, 202, 764, 966, 0.0289855072464, 2, -1
sanysidro024-2010.png, 146, 799, 945, 0.0656084656085, 2, -1
sanysidro025-2010.png, 3607, 4474, 8081, 0.257641381017, 2, -1
sanysidro026-2010.png, 3983, 4920, 8903, 0.109401325396, 2, -1
sanysidro027-2010.png, 2856, 3693, 6549, 0.0671858298977, 2, -1
sanysidro028-2010.png, 3561, 4692, 8253, 0.0986308009209, 2, -1
sanysidro029-2010.png, 3078, 4189, 7267, 0.0355029585799, 2, -1
sanysidro030-2010.png, 2414, 3781, 6195, 0.0235673930589, 2, -1
sanysidro031-2010.png, 210, 730, 940, 0.0191489361702, 2, -1
sanysidro032-2010.png, 449, 802, 1251, 0.0799360511591, 2, -1
sanysidro033-2010.png, 3226, 4010, 7236, 0.238253178552, 2, -1
sanysidro034-2010.png, 3811, 4598, 8409, 0.101082173861, 2, -1
sanysidro035-2010.png, 3753, 4836, 8589, 0.0558854348585, 2, -1
sanysidro036-2010.png, 3148, 4433, 7581, 0.0432660598866, 2, -1
sanysidro037-2010.png, 3239, 4212, 7451, 0.0483156623272, 2, -1
sanysidro038-2010.png, 1935, 3071, 5006, 0.0327606871754, 2, -1
sanysidro039-2010.png, 216, 745, 961, 0.00624349635796, 2, -1
sanysidro040-2010.png, 279, 521, 800, 0.0125, 2, -1
sanysidro041-2010.png, 3507, 4336, 7843, 0.244804284075, 2, -1
sanysidro042-2010.png, 3837, 4804, 8641, 0.100914246036, 2, -1
sanysidro043-2010.png, 3642, 5027, 8669, 0.0431422309378, 2, -1
sanysidro044-2010.png, 2487, 3070, 5557, 0.0363505488573, 2, -1
sanysidro045-2010.png, 596, 1094, 1690, 0.0508875739645, 2, -1
sanysidro046-2010.png, 927, 1838, 2765, 0.00578661844485, 2, -1
sanysidro047-2010.png, 432, 1057, 1489, 0.0496977837475, 2, -1
sanysidro048-2010.png, 640, 1130, 1770, 0.20790960452, 2, -1
sanysidro049-2010.png, 3435, 4428, 7863, 0.164822586799, 2, -1
sanysidro050-2010.png, 3434, 4417, 7851, 0.0985861673672, 2, -1
sanysidro051-2010.png, 3232, 4407, 7639, 0.0497447309857, 2, -1
sanysidro052-2010.png, 1819, 2814, 4633, 0.0673429743147, 2, -1
sanysidro053-2010.png, 177, 960, 1137, 0.0193491644679, 2, -1
sanysidro054-2010.png, 635, 1655, 2290, 0.0131004366812, 2, -1
sanysidro055-2010.png, 879, 1435, 2314, 0.0259291270527, 2, -1
sanysidro056-2010.png, 947, 1701, 2648, 0.173716012085, 2, -1
sanysidro057-2010.png, 3255, 4405, 7660, 0.207832898172, 2, -1
sanysidro058-2010.png, 4302, 5361, 9663, 0.0728552209459, 2, -1
sanysidro059-2010.png, 3754, 4984, 8738, 0.0496681162737, 2, -1
sanysidro060-2010.png, 2901, 4120, 7021, 0.0415895171628, 2, -1
sanysidro061-2010.png, 1911, 3185, 5096, 0.0467032967033, 2, -1
sanysidro062-2010.png, 472, 1857, 2329, 0.0231859167024, 2, -1
sanysidro063-2010.png, 1423, 2064, 3487, 0.0378548895899, 2, -1
sanysidro064-2010.png, 2693, 3711, 6404, 0.163960024984, 2, -1
yuba001-2010.png, 2187, 3703, 5890, 0.0353140916808, 2, -1
yuba002-2010.png, 2821, 4520, 7341, 0.158289061436, 2, -1
yuba003-2010.png, 1403, 2424, 3827, 0.126992422263, 2, -1
yuba004-2010.png, 2289, 3116, 5405, 0.143200740056, 2, -1
yuba005-2010.png, 432, 505, 937, 0.140875133404, 2, -1
yuba006-2010.png, 1074, 1476, 2550, 0.0776470588235, 2, -1
yuba007-2010.png, 847, 949, 1796, 0.0991091314031, 2, -1
yuba008-2010.png, 470, 413, 883, 0.0634201585504, 2, -1
yuba009-2010.png, 2386, 4137, 6523, 0.0392457458225, 2, -1
yuba010-2010.png, 3008, 4599, 7607, 0.184041014855, 2, -1
yuba011-2010.png, 2183, 3049, 5232, 0.142966360856, 2, -1
yuba012-2010.png, 3032, 4028, 7060, 0.159206798867, 2, -1
yuba013-2010.png, 1586, 2321, 3907, 0.140261069875, 2, -1
yuba014-2010.png, 665, 869, 1534, 0.134289439374, 2, -1
yuba015-2010.png, 735, 958, 1693, 0.105138806852, 2, -1
yuba016-2010.png, 982, 462, 1444, 0.0429362880886, 2, -1
yuba017-2010.png, 2010, 2982, 4992, 0.083733974359, 2, -1
yuba018-2010.png, 3076, 4574, 7650, 0.181176470588, 2, -1
yuba019-2010.png, 2724, 3919, 6643, 0.16980279994, 2, -1
yuba020-2010.png, 1218, 2099, 3317, 0.167621344588, 2, -1
yuba021-2010.png, 1147, 1853, 3000, 0.138, 2, -1
yuba022-2010.png, 790, 1104, 1894, 0.106652587117, 2, -1
yuba023-2010.png, 501, 938, 1439, 0.0792216817234, 2, -1
yuba024-2010.png, 1111, 724, 1835, 0.0610354223433, 2, -1
yuba025-2010.png, 2470, 3961, 6431, 0.0556678588089, 2, -1
yuba026-2010.png, 1641, 2936, 4577, 0.1179812104, 2, -1
yuba027-2010.png, 2639, 3371, 6010, 0.152745424293, 2, -1
yuba028-2010.png, 1622, 2541, 4163, 0.178717271199, 2, -1
yuba029-2010.png, 934, 1920, 2854, 0.126839523476, 2, -1
yuba030-2010.png, 1392, 1970, 3362, 0.0797144556811, 2, -1
yuba031-2010.png, 1228, 1660, 2888, 0.0713296398892, 2, -1
yuba032-2010.png, 994, 621, 1615, 0.0433436532508, 2, -1
yuba033-2010.png, 740, 1318, 2058, 0.0767735665695, 2, -1
yuba034-2010.png, 818, 1589, 2407, 0.112172829248, 2, -1
yuba035-2010.png, 1338, 1736, 3074, 0.225764476252, 2, -1
yuba036-2010.png, 570, 773, 1343, 0.150409530901, 2, -1
yuba037-2010.png, 1793, 2551, 4344, 0.114640883978, 2, -1
yuba038-2010.png, 2070, 2864, 4934, 0.0721524118362, 2, -1
yuba039-2010.png, 1772, 2644, 4416, 0.0557065217391, 2, -1
yuba040-2010.png, 1710, 2155, 3865, 0.0382923673997, 2, -1
yuba041-2010.png, 654, 1225, 1879, 0.075572112826, 2, -1
yuba042-2010.png, 989, 1972, 2961, 0.081053698075, 2, -1
yuba043-2010.png, 1009, 1204, 2213, 0.133755083597, 2, -1
yuba044-2010.png, 468, 442, 910, 0.18021978022, 2, -1
yuba045-2010.png, 856, 1129, 1985, 0.15314861461, 2, -1
yuba046-2010.png, 1631, 2006, 3637, 0.0791861424251, 2, -1
yuba047-2010.png, 2249, 3190, 5439, 0.0808972237544, 2, -1
yuba048-2010.png, 2247, 3038, 5285, 0.0469252601703, 2, -1
yuba049-2010.png, 1290, 1726, 3016, 0.090848806366, 2, -1
yuba050-2010.png, 1064, 1794, 2858, 0.0965710286914, 2, -1
yuba051-2010.png, 1111, 1444, 2555, 0.147162426614, 2, -1
yuba052-2010.png, 372, 509, 881, 0.140749148695, 2, -1
yuba053-2010.png, 712, 824, 1536, 0.1015625, 2, -1
yuba054-2010.png, 862, 929, 1791, 0.126186487996, 2, -1
yuba055-2010.png, 1124, 1579, 2703, 0.0932297447281, 2, -1
yuba056-2010.png, 1999, 2996, 4995, 0.0904904904905, 2, -1
yuba057-2010.png, 1408, 1966, 3374, 0.0663900414938, 2, -1
yuba058-2010.png, 850, 1217, 2067, 0.0793420416062, 2, -1
yuba059-2010.png, 1041, 1588, 2629, 0.133130467859, 2, -1
yuba060-2010.png, 661, 894, 1555, 0.141479099678, 2, -1
yuba061-2010.png, 589, 609, 1198, 0.205342237062, 2, -1
yuba062-2010.png, 1504, 2005, 3509, 0.0792248503847, 2, -1
yuba063-2010.png, 799, 888, 1687, 0.130409010077, 2, -1
yuba064-2010.png, 2444, 3235, 5679, 0.0831132241592, 2, -1
