Filename, N_kps1, N_kps2, Total_kps2, N_matches, average_match_rate, n_forward, n_backward, n_not_first_match_forward, n_not_first_match_backward
jenner001-2010.png, 1336, 1690, 3026, 353, 0.233311302049, 415, 457, 80, 108
jenner002-2010.png, 1386, 1736, 3122, 395, 0.253042921204, 468, 494, 88, 97
jenner003-2010.png, 1994, 1914, 3908, 551, 0.28198567042, 661, 686, 153, 147
jenner004-2010.png, 869, 966, 1835, 346, 0.377111716621, 408, 430, 51, 53
jenner005-2010.png, 854, 1209, 2063, 201, 0.194861851672, 239, 249, 56, 52
jenner006-2010.png, 1570, 2199, 3769, 1002, 0.531706022818, 1118, 1170, 98, 107
jenner007-2010.png, 1250, 2001, 3251, 699, 0.430021531836, 801, 858, 85, 116
jenner008-2010.png, 2150, 3346, 5496, 1098, 0.399563318777, 1238, 1324, 181, 196
jenner009-2010.png, 840, 1123, 1963, 381, 0.388181355069, 453, 463, 51, 58
jenner010-2010.png, 724, 974, 1698, 191, 0.224970553592, 222, 250, 36, 53
jenner011-2010.png, 890, 753, 1643, 198, 0.241022519781, 241, 247, 42, 57
jenner012-2010.png, 1523, 1986, 3509, 665, 0.379025363351, 766, 825, 101, 131
jenner013-2010.png, 1636, 2200, 3836, 645, 0.336287799791, 746, 773, 116, 141
jenner014-2010.png, 1337, 1361, 2698, 437, 0.323943661972, 499, 538, 79, 82
jenner015-2010.png, 1017, 1080, 2097, 459, 0.437768240343, 515, 532, 41, 66
jenner016-2010.png, 1309, 2044, 3353, 681, 0.40620339994, 765, 847, 91, 129
jenner017-2010.png, 1228, 1132, 2360, 492, 0.416949152542, 565, 604, 57, 68
jenner018-2010.png, 1348, 1743, 3091, 528, 0.341637010676, 597, 645, 80, 103
jenner019-2010.png, 1478, 1297, 2775, 195, 0.140540540541, 248, 267, 73, 87
jenner020-2010.png, 989, 1401, 2390, 468, 0.391631799163, 534, 554, 67, 68
jenner021-2010.png, 1476, 2268, 3744, 586, 0.313034188034, 668, 731, 129, 150
jenner022-2010.png, 1415, 1433, 2848, 496, 0.348314606742, 561, 595, 70, 95
jenner023-2010.png, 1072, 1226, 2298, 583, 0.507397737163, 661, 682, 50, 65
jenner024-2010.png, 1623, 2474, 4097, 970, 0.473517207713, 1084, 1140, 117, 149
jenner025-2010.png, 2194, 2647, 4841, 1288, 0.532121462508, 1428, 1484, 116, 120
jenner026-2010.png, 1318, 1739, 3057, 478, 0.312724893687, 553, 579, 77, 95
jenner027-2010.png, 1992, 2366, 4358, 686, 0.314823313447, 790, 832, 110, 143
jenner028-2010.png, 636, 714, 1350, 188, 0.278518518519, 222, 233, 45, 48
jenner029-2010.png, 1944, 2932, 4876, 1079, 0.44257588187, 1194, 1264, 127, 149
jenner030-2010.png, 1420, 2233, 3653, 816, 0.446756090884, 908, 961, 104, 113
jenner031-2010.png, 1327, 1958, 3285, 746, 0.454185692542, 824, 867, 98, 106
jenner032-2010.png, 1806, 2410, 4216, 995, 0.472011385199, 1111, 1190, 120, 157
jenner033-2010.png, 1759, 2209, 3968, 959, 0.483366935484, 1063, 1106, 117, 130
jenner034-2010.png, 1742, 2115, 3857, 590, 0.305937256935, 665, 721, 87, 119
jenner035-2010.png, 2048, 2334, 4382, 852, 0.388863532634, 971, 1007, 117, 122
jenner036-2010.png, 883, 1350, 2233, 410, 0.367218987909, 459, 510, 55, 68
jenner037-2010.png, 1329, 2112, 3441, 637, 0.370241208951, 722, 780, 83, 105
jenner038-2010.png, 1001, 1637, 2638, 533, 0.404094010614, 607, 657, 76, 86
jenner039-2010.png, 483, 732, 1215, 226, 0.372016460905, 277, 283, 35, 39
jenner040-2010.png, 1013, 1391, 2404, 498, 0.414309484193, 549, 604, 64, 84
jenner041-2010.png, 1641, 1929, 3570, 713, 0.39943977591, 804, 820, 108, 101
jenner042-2010.png, 2083, 3109, 5192, 1089, 0.419491525424, 1215, 1303, 141, 160
jenner043-2010.png, 1566, 1872, 3438, 658, 0.382780686446, 763, 780, 92, 112
jenner044-2010.png, 1060, 1458, 2518, 535, 0.424940428912, 603, 642, 73, 82
jenner045-2010.png, 1221, 1880, 3101, 578, 0.372782973234, 644, 699, 77, 82
jenner046-2010.png, 1455, 2268, 3723, 985, 0.529143164115, 1087, 1147, 78, 93
jenner047-2010.png, 933, 1426, 2359, 456, 0.386604493429, 514, 552, 76, 69
jenner048-2010.png, 1545, 2294, 3839, 859, 0.447512373014, 963, 1022, 109, 120
jenner049-2010.png, 1240, 1826, 3066, 588, 0.383561643836, 642, 702, 70, 86
jenner050-2010.png, 1372, 2260, 3632, 709, 0.390418502203, 807, 840, 101, 107
jenner051-2010.png, 1050, 1389, 2439, 418, 0.342763427634, 489, 498, 84, 75
jenner052-2010.png, 948, 1388, 2336, 593, 0.507705479452, 664, 700, 55, 67
jenner053-2010.png, 984, 1586, 2570, 466, 0.362645914397, 544, 579, 69, 80
jenner054-2010.png, 943, 1055, 1998, 451, 0.451451451451, 521, 529, 55, 69
jenner055-2010.png, 714, 1053, 1767, 361, 0.408602150538, 418, 424, 41, 46
jenner056-2010.png, 863, 893, 1756, 295, 0.335990888383, 350, 354, 50, 51
jenner057-2010.png, 1414, 1895, 3309, 770, 0.465397401028, 861, 894, 81, 97
jenner058-2010.png, 1251, 2338, 3589, 675, 0.376149345222, 751, 819, 90, 98
jenner059-2010.png, 1383, 1845, 3228, 732, 0.453531598513, 827, 834, 107, 102
jenner060-2010.png, 728, 911, 1639, 329, 0.401464307505, 379, 388, 45, 43
jenner061-2010.png, 661, 891, 1552, 210, 0.270618556701, 246, 268, 42, 45
jenner062-2010.png, 529, 689, 1218, 229, 0.376026272578, 269, 271, 30, 29
jenner063-2010.png, 1006, 1422, 2428, 526, 0.433278418451, 592, 617, 65, 72
jenner064-2010.png, 984, 1097, 2081, 379, 0.364247957713, 448, 467, 48, 74
losangeles001-2010.png, 2812, 4486, 7298, 948, 0.259797204714, 1100, 1110, 204, 193
losangeles002-2010.png, 2723, 5495, 8218, 1114, 0.271112192748, 1245, 1318, 203, 219
losangeles003-2010.png, 1099, 4306, 5405, 625, 0.231267345051, 699, 759, 102, 124
losangeles004-2010.png, 765, 3621, 4386, 264, 0.120383036936, 314, 353, 57, 69
losangeles005-2010.png, 1090, 4385, 5475, 579, 0.211506849315, 639, 728, 87, 105
losangeles006-2010.png, 1398, 4589, 5987, 786, 0.262568899282, 877, 957, 111, 128
losangeles007-2010.png, 2011, 4605, 6616, 1236, 0.373639661427, 1379, 1449, 118, 149
losangeles008-2010.png, 1740, 4585, 6325, 1129, 0.356996047431, 1221, 1306, 103, 129
losangeles009-2010.png, 2437, 5374, 7811, 960, 0.245807194981, 1092, 1202, 212, 240
losangeles010-2010.png, 2584, 5039, 7623, 1280, 0.335825790371, 1409, 1466, 156, 165
losangeles011-2010.png, 1183, 4625, 5808, 745, 0.256542699725, 800, 869, 75, 97
losangeles012-2010.png, 1815, 4450, 6265, 1082, 0.345411013567, 1183, 1312, 132, 170
losangeles013-2010.png, 1355, 4644, 5999, 823, 0.274379063177, 901, 992, 85, 99
losangeles014-2010.png, 2096, 5013, 7109, 1313, 0.369390912927, 1450, 1490, 124, 136
losangeles015-2010.png, 1163, 3053, 4216, 731, 0.346774193548, 804, 890, 74, 94
losangeles016-2010.png, 1329, 4377, 5706, 771, 0.270241850683, 851, 922, 98, 128
losangeles017-2010.png, 2882, 5009, 7891, 1013, 0.256748194145, 1170, 1212, 239, 263
losangeles018-2010.png, 3039, 4381, 7420, 1654, 0.445822102426, 1829, 1860, 189, 193
losangeles019-2010.png, 1164, 3885, 5049, 737, 0.291938997821, 802, 887, 66, 90
losangeles020-2010.png, 1587, 3961, 5548, 847, 0.305335255948, 957, 1023, 123, 156
losangeles021-2010.png, 1923, 4336, 6259, 1069, 0.341588113117, 1183, 1232, 123, 151
losangeles022-2010.png, 1996, 5029, 7025, 1233, 0.35103202847, 1352, 1450, 142, 158
losangeles023-2010.png, 1303, 4360, 5663, 849, 0.299841073636, 919, 983, 65, 83
losangeles024-2010.png, 2064, 4942, 7006, 1183, 0.337710533828, 1296, 1378, 118, 156
losangeles025-2010.png, 2458, 4944, 7402, 812, 0.219400162118, 937, 988, 211, 208
losangeles026-2010.png, 2706, 4682, 7388, 1485, 0.402003248511, 1639, 1718, 194, 233
losangeles027-2010.png, 1506, 4338, 5844, 910, 0.311430527036, 1005, 1096, 80, 112
losangeles028-2010.png, 1457, 4158, 5615, 898, 0.319857524488, 988, 1059, 92, 111
losangeles029-2010.png, 2505, 4529, 7034, 1573, 0.447256184248, 1707, 1778, 139, 167
losangeles030-2010.png, 1972, 4783, 6755, 1164, 0.344633604737, 1266, 1322, 131, 141
losangeles031-2010.png, 2058, 4444, 6502, 1199, 0.368809597047, 1311, 1374, 123, 127
losangeles032-2010.png, 1994, 4683, 6677, 1197, 0.358544256403, 1298, 1396, 115, 158
losangeles033-2010.png, 3249, 5152, 8401, 1230, 0.292822283062, 1406, 1466, 270, 266
losangeles034-2010.png, 3019, 5148, 8167, 944, 0.231174237786, 1098, 1146, 209, 237
losangeles035-2010.png, 1434, 4312, 5746, 831, 0.28924469196, 917, 1008, 88, 124
losangeles036-2010.png, 1587, 4362, 5949, 911, 0.306269961338, 996, 1042, 104, 115
losangeles037-2010.png, 1793, 4420, 6213, 1058, 0.34057621117, 1147, 1229, 117, 120
losangeles038-2010.png, 1836, 4610, 6446, 1101, 0.341607198262, 1211, 1307, 116, 136
losangeles039-2010.png, 2320, 4687, 7007, 1489, 0.425003567861, 1622, 1729, 125, 167
losangeles040-2010.png, 2130, 4472, 6602, 1356, 0.410784610724, 1474, 1531, 122, 143
losangeles041-2010.png, 3502, 5443, 8945, 1026, 0.229401900503, 1199, 1207, 271, 258
losangeles042-2010.png, 3213, 4600, 7813, 1381, 0.353513375144, 1512, 1577, 170, 213
losangeles043-2010.png, 1554, 4023, 5577, 910, 0.32634032634, 995, 1078, 114, 142
losangeles044-2010.png, 1074, 4263, 5337, 539, 0.201986134533, 583, 663, 71, 99
losangeles045-2010.png, 1820, 4636, 6456, 967, 0.299566294919, 1072, 1114, 108, 129
losangeles046-2010.png, 1928, 4482, 6410, 1093, 0.341029641186, 1194, 1267, 127, 156
losangeles047-2010.png, 2160, 4525, 6685, 1387, 0.414958863126, 1524, 1597, 119, 135
losangeles048-2010.png, 1770, 4411, 6181, 998, 0.322925093027, 1072, 1139, 98, 130
losangeles049-2010.png, 3454, 5237, 8691, 983, 0.226211022897, 1165, 1172, 257, 276
losangeles050-2010.png, 3032, 4264, 7296, 1618, 0.443530701754, 1768, 1827, 162, 194
losangeles051-2010.png, 1732, 4374, 6106, 985, 0.32263347527, 1056, 1143, 104, 134
losangeles052-2010.png, 1759, 4741, 6500, 1025, 0.315384615385, 1115, 1197, 103, 147
losangeles053-2010.png, 2388, 4513, 6901, 1337, 0.387480075351, 1476, 1531, 143, 177
losangeles054-2010.png, 2707, 4884, 7591, 1690, 0.445264128573, 1834, 1878, 157, 182
losangeles055-2010.png, 2183, 4330, 6513, 1412, 0.433594349762, 1523, 1578, 110, 106
losangeles056-2010.png, 1956, 4050, 6006, 1080, 0.35964035964, 1193, 1272, 134, 161
losangeles057-2010.png, 3198, 5004, 8202, 1079, 0.263106559376, 1232, 1320, 250, 291
losangeles058-2010.png, 2891, 4572, 7463, 1206, 0.323194425834, 1323, 1379, 170, 191
losangeles059-2010.png, 1694, 4513, 6207, 786, 0.253262445626, 851, 964, 116, 132
losangeles060-2010.png, 2038, 4842, 6880, 1131, 0.328779069767, 1238, 1313, 150, 152
losangeles061-2010.png, 2186, 4729, 6915, 1189, 0.343890093999, 1306, 1409, 116, 168
losangeles062-2010.png, 2327, 4639, 6966, 1333, 0.382716049383, 1467, 1486, 150, 146
losangeles063-2010.png, 1800, 4148, 5948, 1050, 0.353059852051, 1154, 1229, 124, 142
losangeles064-2010.png, 2102, 4384, 6486, 1163, 0.358618563059, 1285, 1344, 144, 144
merced001-2010.png, 3139, 5248, 8387, 1413, 0.336950041731, 1559, 1603, 238, 220
merced002-2010.png, 2814, 4640, 7454, 901, 0.241749396297, 1010, 1117, 187, 230
merced003-2010.png, 840, 1557, 2397, 376, 0.313725490196, 439, 480, 81, 88
merced004-2010.png, 1189, 1857, 3046, 545, 0.357846355877, 644, 684, 114, 115
merced005-2010.png, 664, 1115, 1779, 230, 0.258572231591, 269, 303, 37, 40
merced006-2010.png, 373, 741, 1114, 86, 0.154398563734, 114, 131, 28, 25
merced007-2010.png, 381, 695, 1076, 63, 0.117100371747, 86, 101, 28, 32
merced008-2010.png, 342, 307, 649, 52, 0.160246533128, 71, 68, 22, 23
merced009-2010.png, 1935, 4787, 6722, 894, 0.265992264207, 989, 1057, 144, 153
merced010-2010.png, 1661, 4436, 6097, 632, 0.207315072987, 707, 799, 125, 141
merced011-2010.png, 871, 1275, 2146, 149, 0.138863000932, 187, 213, 59, 52
merced012-2010.png, 986, 1650, 2636, 378, 0.286798179059, 467, 496, 96, 105
merced013-2010.png, 777, 1033, 1810, 195, 0.21546961326, 260, 282, 64, 76
merced014-2010.png, 997, 1557, 2554, 276, 0.21613155834, 343, 383, 100, 104
merced015-2010.png, 377, 1515, 1892, 174, 0.183932346723, 200, 254, 37, 53
merced016-2010.png, 556, 935, 1491, 266, 0.356807511737, 319, 340, 47, 64
merced017-2010.png, 731, 2268, 2999, 206, 0.137379126375, 241, 303, 62, 80
merced018-2010.png, 1141, 2128, 3269, 269, 0.164576323035, 318, 366, 95, 106
merced019-2010.png, 708, 1098, 1806, 42, 0.046511627907, 63, 93, 32, 35
merced020-2010.png, 601, 685, 1286, 188, 0.292379471229, 235, 232, 57, 60
merced021-2010.png, 849, 400, 1249, 64, 0.102481985588, 113, 84, 53, 36
merced022-2010.png, 876, 508, 1384, 167, 0.241329479769, 209, 203, 41, 45
merced023-2010.png, 691, 860, 1551, 204, 0.263056092843, 261, 295, 79, 74
merced024-2010.png, 275, 692, 967, 82, 0.169596690796, 110, 142, 32, 52
merced025-2010.png, 677, 1549, 2226, 157, 0.141060197664, 204, 251, 62, 75
merced026-2010.png, 1237, 1570, 2807, 384, 0.273601710011, 460, 493, 107, 120
merced027-2010.png, 1365, 1716, 3081, 188, 0.122038299253, 265, 246, 89, 78
merced028-2010.png, 605, 367, 972, 70, 0.144032921811, 107, 87, 38, 25
merced029-2010.png, 1354, 93, 1447, 16, 0.0221147201106, 42, 21, 15, 6
merced030-2010.png, 1395, 93, 1488, 22, 0.0295698924731, 56, 25, 17, 7
merced031-2010.png, 543, 385, 928, 155, 0.334051724138, 200, 202, 29, 38
merced032-2010.png, 271, 187, 458, 27, 0.117903930131, 43, 37, 9, 11
merced033-2010.png, 1325, 1711, 3036, 471, 0.310276679842, 574, 589, 116, 110
merced034-2010.png, 1288, 1745, 3033, 226, 0.149027365645, 285, 324, 87, 97
merced035-2010.png, 565, 400, 965, 81, 0.167875647668, 122, 106, 34, 35
merced036-2010.png, 1473, 437, 1910, 193, 0.202094240838, 282, 224, 58, 33
merced037-2010.png, 2501, 496, 2997, 227, 0.151484818151, 320, 261, 49, 40
merced038-2010.png, 1461, 83, 1544, 25, 0.0323834196891, 52, 31, 11, 8
merced039-2010.png, 618, 235, 853, 85, 0.199296600234, 131, 97, 29, 20
merced040-2010.png, 706, 396, 1102, 67, 0.121597096189, 92, 88, 31, 38
merced041-2010.png, 1200, 1569, 2769, 530, 0.382809678584, 631, 634, 112, 123
merced042-2010.png, 1175, 878, 2053, 123, 0.119824646858, 176, 157, 63, 55
merced043-2010.png, 1160, 126, 1286, 59, 0.0917573872473, 96, 68, 20, 16
merced044-2010.png, 1606, 345, 1951, 80, 0.0820092260379, 143, 100, 49, 38
merced045-2010.png, 3044, 386, 3430, 206, 0.120116618076, 310, 227, 59, 45
merced046-2010.png, 1927, 183, 2110, 75, 0.0710900473934, 128, 84, 21, 17
merced047-2010.png, 1019, 422, 1441, 224, 0.310895211659, 286, 244, 44, 31
merced048-2010.png, 979, 1226, 2205, 150, 0.136054421769, 190, 215, 59, 69
merced049-2010.png, 529, 1152, 1681, 225, 0.267697798929, 282, 296, 65, 70
merced050-2010.png, 551, 171, 722, 53, 0.146814404432, 89, 67, 26, 20
merced051-2010.png, 1269, 214, 1483, 38, 0.0512474713419, 71, 51, 19, 9
merced052-2010.png, 2207, 290, 2497, 68, 0.0544653584301, 119, 83, 35, 22
merced053-2010.png, 2051, 176, 2227, 42, 0.0377189043556, 82, 47, 23, 18
merced054-2010.png, 1768, 125, 1893, 34, 0.0359218172213, 71, 43, 25, 16
merced055-2010.png, 600, 155, 755, 58, 0.153642384106, 82, 64, 24, 16
merced056-2010.png, 717, 853, 1570, 78, 0.0993630573248, 102, 123, 40, 52
merced057-2010.png, 600, 566, 1166, 76, 0.130360205832, 109, 100, 29, 24
merced058-2010.png, 422, 84, 506, 20, 0.0790513833992, 36, 29, 6, 6
merced059-2010.png, 883, 180, 1063, 45, 0.0846660395108, 74, 54, 23, 19
merced060-2010.png, 1216, 218, 1434, 20, 0.0278940027894, 49, 31, 28, 17
merced061-2010.png, 913, 388, 1301, 58, 0.0891621829362, 94, 78, 36, 26
merced062-2010.png, 1272, 170, 1442, 64, 0.0887656033287, 116, 79, 25, 22
merced063-2010.png, 1486, 218, 1704, 61, 0.0715962441315, 98, 75, 27, 20
merced064-2010.png, 1155, 895, 2050, 173, 0.168780487805, 237, 231, 95, 92
oakland001-2010.png, 2761, 3106, 5867, 755, 0.257371740242, 879, 888, 189, 190
oakland002-2010.png, 3590, 4300, 7890, 761, 0.192902408112, 873, 903, 181, 195
oakland003-2010.png, 3460, 4864, 8324, 1742, 0.418548774628, 1900, 1989, 206, 251
oakland004-2010.png, 3260, 5011, 8271, 1755, 0.424374319913, 1965, 2038, 211, 246
oakland005-2010.png, 2599, 3707, 6306, 1150, 0.364732001269, 1279, 1361, 168, 182
oakland006-2010.png, 1301, 1511, 2812, 312, 0.221906116643, 374, 406, 81, 114
oakland007-2010.png, 1248, 2502, 3750, 677, 0.361066666667, 787, 862, 116, 125
oakland008-2010.png, 1552, 2610, 4162, 1144, 0.549735703988, 1247, 1362, 93, 125
oakland009-2010.png, 2408, 2774, 5182, 591, 0.228097259745, 708, 722, 195, 181
oakland010-2010.png, 3091, 4535, 7626, 1407, 0.369000786782, 1574, 1664, 214, 236
oakland011-2010.png, 2488, 4848, 7336, 1083, 0.295256270447, 1199, 1281, 173, 196
oakland012-2010.png, 2823, 4897, 7720, 1056, 0.273575129534, 1184, 1296, 225, 261
oakland013-2010.png, 1975, 1845, 3820, 227, 0.118848167539, 278, 298, 68, 79
oakland014-2010.png, 1474, 1892, 3366, 555, 0.329768270945, 644, 678, 104, 94
oakland015-2010.png, 2082, 3725, 5807, 1288, 0.443602548648, 1408, 1514, 139, 152
oakland016-2010.png, 1570, 2643, 4213, 991, 0.470448611441, 1104, 1174, 88, 92
oakland017-2010.png, 2838, 3368, 6206, 724, 0.233322591041, 849, 855, 193, 190
oakland018-2010.png, 2784, 4825, 7609, 1336, 0.351163096333, 1462, 1588, 177, 222
oakland019-2010.png, 2598, 4827, 7425, 1226, 0.330235690236, 1359, 1449, 197, 209
oakland020-2010.png, 2825, 4276, 7101, 724, 0.203914941558, 814, 893, 193, 221
oakland021-2010.png, 2126, 3047, 5173, 868, 0.335588633288, 990, 1050, 164, 191
oakland022-2010.png, 3430, 4845, 8275, 1810, 0.43746223565, 1983, 2084, 216, 236
oakland023-2010.png, 2786, 4532, 7318, 1722, 0.470620388084, 1892, 1998, 167, 190
oakland024-2010.png, 1531, 2754, 4285, 983, 0.458809801634, 1092, 1162, 114, 140
oakland025-2010.png, 3377, 4296, 7673, 1200, 0.312785090577, 1369, 1446, 255, 273
oakland026-2010.png, 3570, 5074, 8644, 1658, 0.383618695049, 1829, 1867, 219, 212
oakland027-2010.png, 2359, 3418, 5777, 721, 0.249610524494, 822, 907, 175, 194
oakland028-2010.png, 1889, 2822, 4711, 614, 0.260666525154, 707, 771, 150, 150
oakland029-2010.png, 3004, 4369, 7373, 1346, 0.365115963651, 1499, 1564, 209, 218
oakland030-2010.png, 3120, 4352, 7472, 1746, 0.467344753747, 1940, 2009, 209, 251
oakland031-2010.png, 1328, 2739, 4067, 813, 0.399803294812, 919, 981, 91, 119
oakland032-2010.png, 2926, 4793, 7719, 1883, 0.487887031999, 2054, 2146, 180, 211
oakland033-2010.png, 2953, 4769, 7722, 1077, 0.278943278943, 1226, 1293, 242, 235
oakland034-2010.png, 2399, 5176, 7575, 1129, 0.298085808581, 1234, 1320, 154, 181
oakland035-2010.png, 3120, 3598, 6718, 1044, 0.310806787734, 1219, 1251, 216, 216
oakland036-2010.png, 2624, 3812, 6436, 965, 0.299875699192, 1089, 1165, 230, 226
oakland037-2010.png, 3078, 4962, 8040, 1525, 0.379353233831, 1705, 1802, 206, 254
oakland038-2010.png, 2036, 3732, 5768, 1204, 0.417475728155, 1341, 1450, 148, 161
oakland039-2010.png, 3112, 4868, 7980, 1973, 0.494486215539, 2130, 2277, 166, 217
oakland040-2010.png, 3026, 5197, 8223, 1930, 0.469415055333, 2066, 2182, 182, 225
oakland041-2010.png, 2623, 4720, 7343, 1062, 0.289255072859, 1178, 1278, 190, 216
oakland042-2010.png, 2242, 3661, 5903, 688, 0.233101812638, 772, 876, 134, 159
oakland043-2010.png, 2775, 2958, 5733, 1215, 0.423861852433, 1343, 1398, 168, 179
oakland044-2010.png, 2789, 3620, 6409, 1313, 0.409736308316, 1503, 1548, 186, 208
oakland045-2010.png, 3397, 5065, 8462, 1331, 0.314582840936, 1482, 1544, 267, 260
oakland046-2010.png, 2852, 4392, 7244, 1324, 0.365543898399, 1463, 1580, 194, 227
oakland047-2010.png, 2598, 4121, 6719, 1566, 0.466140794761, 1684, 1817, 151, 182
oakland048-2010.png, 2666, 4838, 7504, 1748, 0.465884861407, 1882, 1993, 143, 189
oakland049-2010.png, 3040, 3930, 6970, 899, 0.257962697274, 1044, 1101, 233, 245
oakland050-2010.png, 1417, 2068, 3485, 323, 0.185365853659, 384, 435, 105, 106
oakland051-2010.png, 1941, 2190, 4131, 601, 0.290970709271, 709, 739, 127, 135
oakland052-2010.png, 1613, 2367, 3980, 554, 0.278391959799, 644, 677, 110, 119
oakland053-2010.png, 2172, 3033, 5205, 911, 0.35004803074, 1036, 1094, 183, 188
oakland054-2010.png, 1918, 2677, 4595, 878, 0.382154515778, 990, 1056, 119, 163
oakland055-2010.png, 2938, 4189, 7127, 1771, 0.496983302933, 1923, 2026, 154, 204
oakland056-2010.png, 2645, 5267, 7912, 1808, 0.457027300303, 1931, 2036, 145, 157
oakland057-2010.png, 1357, 1857, 3214, 298, 0.185438705663, 368, 407, 92, 100
oakland058-2010.png, 2052, 2483, 4535, 605, 0.266813671444, 694, 721, 155, 143
oakland059-2010.png, 1907, 2224, 4131, 695, 0.336480271121, 802, 845, 133, 136
oakland060-2010.png, 2099, 2694, 4793, 652, 0.272063425829, 758, 813, 157, 182
oakland061-2010.png, 2383, 3470, 5853, 1100, 0.375875619341, 1241, 1321, 198, 221
oakland062-2010.png, 1457, 2531, 3988, 754, 0.37813440321, 845, 920, 124, 127
oakland063-2010.png, 1971, 3126, 5097, 1130, 0.4433980773, 1254, 1367, 113, 164
oakland064-2010.png, 2435, 5274, 7709, 1513, 0.392528213776, 1633, 1726, 139, 171
petaluma001-2010.png, 1811, 2427, 4238, 975, 0.460122699387, 1120, 1117, 133, 95
petaluma002-2010.png, 3229, 4499, 7728, 1879, 0.486283643892, 2063, 2106, 200, 188
petaluma003-2010.png, 1388, 2715, 4103, 645, 0.314404094565, 747, 767, 91, 87
petaluma004-2010.png, 1507, 2060, 3567, 306, 0.17157275021, 381, 411, 104, 125
petaluma005-2010.png, 1395, 1631, 3026, 289, 0.191011235955, 342, 361, 84, 94
petaluma006-2010.png, 1005, 1282, 2287, 261, 0.228246611281, 332, 340, 90, 77
petaluma007-2010.png, 1851, 2548, 4399, 726, 0.330075017049, 836, 893, 147, 178
petaluma008-2010.png, 1257, 2298, 3555, 283, 0.159212376934, 346, 384, 93, 99
petaluma009-2010.png, 3558, 4681, 8239, 1840, 0.446656147591, 2034, 2064, 242, 235
petaluma010-2010.png, 3095, 4478, 7573, 1750, 0.462168229235, 1934, 1981, 180, 183
petaluma011-2010.png, 2531, 4316, 6847, 1348, 0.393749087191, 1492, 1560, 145, 187
petaluma012-2010.png, 1017, 1718, 2735, 130, 0.0950639853748, 158, 178, 53, 51
petaluma013-2010.png, 990, 1505, 2495, 102, 0.0817635270541, 119, 136, 37, 39
petaluma014-2010.png, 1713, 2394, 4107, 653, 0.317993669345, 755, 763, 129, 148
petaluma015-2010.png, 1289, 1938, 3227, 515, 0.319181902696, 602, 639, 108, 105
petaluma016-2010.png, 1447, 2167, 3614, 460, 0.254565578307, 542, 564, 103, 119
petaluma017-2010.png, 3235, 4828, 8063, 1633, 0.405060151308, 1791, 1865, 222, 234
petaluma018-2010.png, 2911, 4583, 7494, 1487, 0.396850813985, 1635, 1719, 176, 202
petaluma019-2010.png, 1765, 3305, 5070, 856, 0.337672583826, 945, 1035, 114, 155
petaluma020-2010.png, 1659, 2243, 3902, 432, 0.221424910302, 538, 545, 115, 129
petaluma021-2010.png, 1750, 1978, 3728, 566, 0.30364806867, 657, 674, 104, 113
petaluma022-2010.png, 2460, 3119, 5579, 1377, 0.493636852483, 1546, 1577, 171, 187
petaluma023-2010.png, 1662, 2260, 3922, 544, 0.277409484957, 645, 681, 139, 137
petaluma024-2010.png, 2001, 2933, 4934, 697, 0.282529387921, 821, 862, 145, 155
petaluma025-2010.png, 2730, 3766, 6496, 1390, 0.427955665025, 1554, 1579, 190, 192
petaluma026-2010.png, 1867, 2920, 4787, 692, 0.2891163568, 794, 857, 132, 161
petaluma027-2010.png, 1388, 2002, 3390, 565, 0.333333333333, 646, 690, 111, 115
petaluma028-2010.png, 1939, 2473, 4412, 521, 0.236174070716, 635, 658, 132, 147
petaluma029-2010.png, 2285, 2914, 5199, 1231, 0.47355260627, 1379, 1432, 172, 209
petaluma030-2010.png, 1887, 2674, 4561, 873, 0.382810787108, 994, 1026, 123, 163
petaluma031-2010.png, 1243, 2409, 3652, 420, 0.230010952903, 493, 545, 137, 146
petaluma032-2010.png, 2446, 3922, 6368, 827, 0.259736180905, 944, 1017, 171, 213
petaluma033-2010.png, 2723, 3295, 6018, 893, 0.296776337654, 1036, 1056, 185, 166
petaluma034-2010.png, 1327, 1817, 3144, 400, 0.254452926209, 498, 474, 122, 103
petaluma035-2010.png, 2014, 2452, 4466, 714, 0.319749216301, 853, 864, 135, 149
petaluma036-2010.png, 2084, 3052, 5136, 916, 0.356697819315, 1043, 1101, 196, 228
petaluma037-2010.png, 3121, 3918, 7039, 1695, 0.481602500355, 1878, 1918, 225, 246
petaluma038-2010.png, 2575, 3727, 6302, 1211, 0.384322437321, 1355, 1431, 173, 214
petaluma039-2010.png, 2596, 4783, 7379, 1085, 0.294077788318, 1209, 1305, 190, 205
petaluma040-2010.png, 2205, 4441, 6646, 1026, 0.308757147156, 1136, 1249, 166, 210
petaluma041-2010.png, 1398, 2077, 3475, 368, 0.211798561151, 438, 461, 96, 99
petaluma042-2010.png, 1999, 2600, 4599, 1044, 0.454011741683, 1146, 1205, 123, 140
petaluma043-2010.png, 2372, 3390, 5762, 1270, 0.440819160014, 1422, 1482, 198, 192
petaluma044-2010.png, 2290, 3301, 5591, 1234, 0.441423716688, 1352, 1436, 153, 178
petaluma045-2010.png, 2158, 2739, 4897, 1127, 0.460281805187, 1263, 1333, 151, 182
petaluma046-2010.png, 2466, 3759, 6225, 1146, 0.368192771084, 1284, 1364, 198, 218
petaluma047-2010.png, 3036, 5139, 8175, 1509, 0.369174311927, 1681, 1738, 230, 215
petaluma048-2010.png, 1855, 3085, 4940, 1020, 0.412955465587, 1106, 1191, 122, 164
petaluma049-2010.png, 2015, 2932, 4947, 795, 0.321406913281, 914, 969, 135, 161
petaluma050-2010.png, 2286, 3207, 5493, 1199, 0.436555616239, 1323, 1375, 159, 153
petaluma051-2010.png, 2251, 3318, 5569, 1330, 0.477644101275, 1489, 1555, 169, 166
petaluma052-2010.png, 1651, 2417, 4068, 671, 0.329891838741, 775, 827, 131, 167
petaluma053-2010.png, 1296, 1280, 2576, 410, 0.318322981366, 488, 486, 86, 80
petaluma054-2010.png, 2376, 3830, 6206, 1217, 0.392201095714, 1344, 1427, 181, 200
petaluma055-2010.png, 2402, 3747, 6149, 1319, 0.429012847617, 1457, 1505, 167, 185
petaluma056-2010.png, 2087, 3228, 5315, 1023, 0.384948259643, 1156, 1225, 177, 194
petaluma057-2010.png, 1208, 1699, 2907, 397, 0.273133814929, 481, 507, 94, 107
petaluma058-2010.png, 2369, 3218, 5587, 1160, 0.415249686773, 1319, 1350, 175, 201
petaluma059-2010.png, 1946, 3127, 5073, 1157, 0.456140350877, 1261, 1352, 128, 161
petaluma060-2010.png, 1266, 1591, 2857, 493, 0.345117255863, 574, 605, 107, 110
petaluma061-2010.png, 2113, 2850, 4963, 918, 0.36993753778, 1038, 1095, 154, 179
petaluma062-2010.png, 2747, 3928, 6675, 1360, 0.407490636704, 1534, 1589, 198, 224
petaluma063-2010.png, 1502, 1906, 3408, 577, 0.338615023474, 650, 678, 106, 103
petaluma064-2010.png, 1987, 2713, 4700, 903, 0.384255319149, 1040, 1084, 167, 179
sanjose001-2010.png, 3407, 5240, 8647, 1432, 0.331213137504, 1612, 1686, 228, 256
sanjose002-2010.png, 3231, 4504, 7735, 1278, 0.330446024564, 1423, 1505, 213, 250
sanjose003-2010.png, 3121, 4607, 7728, 1262, 0.326604554865, 1408, 1490, 212, 257
sanjose004-2010.png, 2890, 4235, 7125, 1545, 0.433684210526, 1710, 1758, 206, 212
sanjose005-2010.png, 2566, 4936, 7502, 1003, 0.267395361237, 1120, 1193, 164, 202
sanjose006-2010.png, 2199, 4378, 6577, 1286, 0.391059753687, 1393, 1486, 141, 165
sanjose007-2010.png, 2193, 3902, 6095, 1255, 0.411812961444, 1371, 1440, 131, 120
sanjose008-2010.png, 1142, 2425, 3567, 750, 0.420521446594, 820, 903, 76, 121
sanjose009-2010.png, 3383, 5016, 8399, 1151, 0.274080247649, 1318, 1373, 240, 272
sanjose010-2010.png, 3320, 4764, 8084, 1167, 0.28871845621, 1303, 1334, 214, 220
sanjose011-2010.png, 4052, 4948, 9000, 1324, 0.294222222222, 1510, 1557, 288, 296
sanjose012-2010.png, 2508, 4327, 6835, 1109, 0.324506217996, 1242, 1354, 171, 228
sanjose013-2010.png, 2191, 4203, 6394, 828, 0.258992805755, 935, 976, 157, 164
sanjose014-2010.png, 2340, 4267, 6607, 1192, 0.360829423339, 1306, 1392, 145, 165
sanjose015-2010.png, 2302, 3575, 5877, 1109, 0.377403437128, 1239, 1295, 139, 156
sanjose016-2010.png, 1797, 3347, 5144, 1078, 0.419129082426, 1201, 1249, 147, 149
sanjose017-2010.png, 3419, 4856, 8275, 1135, 0.274320241692, 1316, 1378, 230, 253
sanjose018-2010.png, 2229, 3070, 5299, 917, 0.346103038309, 1046, 1111, 167, 204
sanjose019-2010.png, 3013, 4304, 7317, 1207, 0.3299166325, 1356, 1410, 202, 210
sanjose020-2010.png, 2496, 4409, 6905, 1197, 0.346705286025, 1322, 1415, 162, 181
sanjose021-2010.png, 2557, 4776, 7333, 1036, 0.282558298104, 1150, 1208, 166, 204
sanjose022-2010.png, 2590, 3963, 6553, 1372, 0.418739508622, 1515, 1588, 174, 205
sanjose023-2010.png, 1507, 2239, 3746, 856, 0.45702082221, 964, 1007, 126, 108
sanjose024-2010.png, 1041, 2398, 3439, 552, 0.321023553359, 620, 702, 81, 116
sanjose025-2010.png, 3066, 3670, 6736, 1377, 0.408847980998, 1567, 1554, 208, 210
sanjose026-2010.png, 3515, 4266, 7781, 1549, 0.398149338131, 1702, 1766, 225, 236
sanjose027-2010.png, 2814, 4099, 6913, 1387, 0.401272963981, 1574, 1643, 229, 205
sanjose028-2010.png, 2762, 4709, 7471, 1574, 0.421362602061, 1715, 1816, 169, 205
sanjose029-2010.png, 2847, 5096, 7943, 1286, 0.323807125771, 1414, 1489, 166, 190
sanjose030-2010.png, 1868, 2826, 4694, 881, 0.375372816361, 987, 1020, 142, 146
sanjose031-2010.png, 1819, 2804, 4623, 1066, 0.461172398875, 1180, 1262, 99, 149
sanjose032-2010.png, 1496, 3136, 4632, 988, 0.426597582038, 1090, 1181, 96, 130
sanjose033-2010.png, 3051, 4587, 7638, 1081, 0.283058392249, 1214, 1337, 195, 271
sanjose034-2010.png, 3289, 4443, 7732, 1666, 0.430936368339, 1818, 1894, 215, 224
sanjose035-2010.png, 3047, 4452, 7499, 1547, 0.412588345113, 1705, 1762, 173, 194
sanjose036-2010.png, 2345, 4761, 7106, 1265, 0.356037151703, 1372, 1489, 157, 194
sanjose037-2010.png, 2906, 4913, 7819, 1453, 0.371658779895, 1601, 1665, 179, 196
sanjose038-2010.png, 1178, 1953, 3131, 700, 0.447141488342, 774, 849, 80, 104
sanjose039-2010.png, 1311, 2078, 3389, 710, 0.419002655651, 795, 839, 91, 97
sanjose040-2010.png, 1940, 3373, 5313, 1208, 0.454733672125, 1319, 1427, 131, 155
sanjose041-2010.png, 3277, 4152, 7429, 1159, 0.312020460358, 1298, 1362, 219, 242
sanjose042-2010.png, 2338, 3927, 6265, 1089, 0.347645650439, 1195, 1252, 157, 188
sanjose043-2010.png, 2894, 4252, 7146, 1714, 0.479708928072, 1877, 1955, 190, 200
sanjose044-2010.png, 2646, 4390, 7036, 1230, 0.349630471859, 1373, 1420, 175, 203
sanjose045-2010.png, 1210, 2106, 3316, 297, 0.179131483715, 366, 412, 104, 122
sanjose046-2010.png, 861, 1617, 2478, 467, 0.376916868442, 534, 581, 55, 70
sanjose047-2010.png, 1751, 3009, 4760, 1126, 0.473109243697, 1231, 1312, 101, 127
sanjose048-2010.png, 2016, 3930, 5946, 1330, 0.447359569458, 1444, 1551, 116, 153
sanjose049-2010.png, 1913, 2850, 4763, 406, 0.170480789418, 514, 519, 150, 146
sanjose050-2010.png, 2138, 3699, 5837, 730, 0.250128490663, 834, 924, 178, 213
sanjose051-2010.png, 2874, 4300, 7174, 1396, 0.389183161416, 1539, 1613, 197, 203
sanjose052-2010.png, 1242, 1880, 3122, 508, 0.325432415119, 596, 594, 106, 103
sanjose053-2010.png, 1107, 1943, 3050, 457, 0.299672131148, 535, 582, 94, 117
sanjose054-2010.png, 1556, 2193, 3749, 930, 0.496132301947, 1043, 1104, 104, 120
sanjose055-2010.png, 1665, 2624, 4289, 967, 0.450920960597, 1067, 1133, 93, 107
sanjose056-2010.png, 1340, 2515, 3855, 894, 0.463813229572, 982, 1043, 85, 99
sanjose057-2010.png, 1077, 1910, 2987, 261, 0.174757281553, 308, 369, 76, 103
sanjose058-2010.png, 2181, 3799, 5980, 1004, 0.335785953177, 1147, 1193, 171, 169
sanjose059-2010.png, 2078, 3289, 5367, 847, 0.315632569406, 968, 1023, 143, 154
sanjose060-2010.png, 1888, 2473, 4361, 471, 0.216005503325, 566, 588, 128, 146
sanjose061-2010.png, 991, 2370, 3361, 399, 0.237429336507, 461, 507, 120, 135
sanjose062-2010.png, 870, 2228, 3098, 552, 0.356358941252, 613, 689, 60, 87
sanjose063-2010.png, 1629, 2433, 4062, 1043, 0.513540128016, 1162, 1209, 94, 104
sanjose064-2010.png, 1636, 3102, 4738, 1123, 0.47403967919, 1228, 1285, 87, 104
sanysidro001-2010.png, 2452, 3438, 5890, 1137, 0.386078098472, 1261, 1306, 163, 158
sanysidro002-2010.png, 3187, 3642, 6829, 1217, 0.356421145116, 1395, 1371, 218, 195
sanysidro003-2010.png, 2748, 3854, 6602, 737, 0.223265677068, 894, 895, 211, 203
sanysidro004-2010.png, 1959, 2468, 4427, 672, 0.303591597018, 771, 805, 140, 152
sanysidro005-2010.png, 1089, 1520, 2609, 235, 0.180145649674, 288, 312, 66, 82
sanysidro006-2010.png, 729, 1590, 2319, 167, 0.144027598103, 204, 230, 52, 58
sanysidro007-2010.png, 768, 1527, 2295, 140, 0.122004357298, 165, 203, 53, 71
sanysidro008-2010.png, 720, 1572, 2292, 353, 0.308027923211, 400, 437, 45, 62
sanysidro009-2010.png, 2206, 2770, 4976, 1149, 0.461816720257, 1279, 1315, 129, 164
sanysidro010-2010.png, 3497, 3792, 7289, 1400, 0.384140485663, 1565, 1586, 220, 225
sanysidro011-2010.png, 3064, 4062, 7126, 1104, 0.309851248948, 1255, 1284, 226, 241
sanysidro012-2010.png, 1874, 2142, 4016, 383, 0.190737051793, 495, 489, 133, 126
sanysidro013-2010.png, 664, 792, 1456, 125, 0.171703296703, 155, 162, 38, 50
sanysidro014-2010.png, 690, 2065, 2755, 209, 0.151724137931, 247, 291, 52, 62
sanysidro015-2010.png, 293, 1094, 1387, 33, 0.0475847152127, 45, 49, 12, 14
sanysidro016-2010.png, 343, 1530, 1873, 177, 0.189001601708, 206, 253, 34, 42
sanysidro017-2010.png, 2716, 3196, 5912, 1222, 0.413396481732, 1362, 1396, 157, 165
sanysidro018-2010.png, 4018, 4407, 8425, 1494, 0.354658753709, 1671, 1680, 239, 243
sanysidro019-2010.png, 4051, 4724, 8775, 1449, 0.330256410256, 1700, 1671, 303, 298
sanysidro020-2010.png, 3036, 3671, 6707, 865, 0.257939466229, 1050, 1055, 230, 217
sanysidro021-2010.png, 2254, 2910, 5164, 477, 0.184740511232, 599, 579, 151, 162
sanysidro022-2010.png, 1031, 2350, 3381, 298, 0.176279207335, 367, 409, 92, 114
sanysidro023-2010.png, 233, 949, 1182, 41, 0.0693739424704, 58, 75, 22, 24
sanysidro024-2010.png, 209, 920, 1129, 102, 0.180690876882, 120, 149, 11, 34
sanysidro025-2010.png, 3341, 4205, 7546, 1872, 0.49615690432, 2034, 2082, 166, 192
sanysidro026-2010.png, 4013, 4780, 8793, 1629, 0.370522006141, 1817, 1856, 289, 291
sanysidro027-2010.png, 3097, 4125, 7222, 1190, 0.329548601495, 1366, 1437, 292, 290
sanysidro028-2010.png, 3600, 4680, 8280, 1574, 0.380193236715, 1753, 1825, 261, 278
sanysidro029-2010.png, 3421, 4472, 7893, 872, 0.220955276828, 1065, 1035, 284, 262
sanysidro030-2010.png, 2135, 3994, 6129, 393, 0.128242780225, 490, 536, 156, 169
sanysidro031-2010.png, 252, 840, 1092, 25, 0.0457875457875, 36, 36, 11, 14
sanysidro032-2010.png, 459, 851, 1310, 159, 0.242748091603, 190, 205, 42, 45
sanysidro033-2010.png, 3078, 3964, 7042, 1784, 0.506674240273, 1962, 2005, 159, 190
sanysidro034-2010.png, 3443, 4525, 7968, 1412, 0.354417670683, 1587, 1655, 239, 248
sanysidro035-2010.png, 3969, 4993, 8962, 1376, 0.307074313769, 1568, 1627, 303, 333
sanysidro036-2010.png, 2835, 4203, 7038, 924, 0.262574595055, 1032, 1106, 219, 241
sanysidro037-2010.png, 3550, 4303, 7853, 885, 0.225391570101, 1063, 1061, 235, 258
sanysidro038-2010.png, 1976, 3292, 5268, 441, 0.167425968109, 519, 565, 137, 167
sanysidro039-2010.png, 335, 1077, 1412, 8, 0.0113314447592, 9, 17, 0, 9
sanysidro040-2010.png, 279, 602, 881, 15, 0.0340522133939, 21, 28, 6, 11
sanysidro041-2010.png, 3307, 4024, 7331, 1845, 0.503341972446, 2025, 2051, 186, 176
sanysidro042-2010.png, 3550, 4710, 8260, 1382, 0.334624697337, 1518, 1598, 217, 280
sanysidro043-2010.png, 3530, 4946, 8476, 1052, 0.24823029731, 1213, 1257, 272, 300
sanysidro044-2010.png, 2384, 3054, 5438, 538, 0.197866862817, 625, 668, 150, 161
sanysidro045-2010.png, 727, 1167, 1894, 111, 0.117212249208, 143, 164, 49, 56
sanysidro046-2010.png, 1080, 2105, 3185, 27, 0.0169544740973, 40, 60, 24, 40
sanysidro047-2010.png, 566, 1145, 1711, 102, 0.119228521333, 130, 139, 33, 38
sanysidro048-2010.png, 670, 1169, 1839, 303, 0.329526916803, 339, 366, 46, 45
sanysidro049-2010.png, 2957, 3976, 6933, 1370, 0.395211308236, 1503, 1542, 176, 166
sanysidro050-2010.png, 3125, 4426, 7551, 1104, 0.292411601112, 1263, 1303, 260, 242
sanysidro051-2010.png, 3322, 4754, 8076, 1140, 0.282317979198, 1276, 1346, 288, 275
sanysidro052-2010.png, 1592, 2903, 4495, 516, 0.229588431591, 619, 670, 108, 137
sanysidro053-2010.png, 204, 1026, 1230, 39, 0.0634146341463, 50, 86, 19, 38
sanysidro054-2010.png, 781, 2032, 2813, 27, 0.0191965872734, 33, 45, 17, 24
sanysidro055-2010.png, 1034, 1592, 2626, 165, 0.125666412795, 209, 218, 52, 53
sanysidro056-2010.png, 999, 1764, 2763, 440, 0.318494390156, 509, 544, 66, 89
sanysidro057-2010.png, 2983, 4252, 7235, 1773, 0.490117484451, 1940, 2000, 164, 184
sanysidro058-2010.png, 3835, 5155, 8990, 1133, 0.252057842047, 1274, 1337, 264, 280
sanysidro059-2010.png, 3760, 5172, 8932, 1163, 0.260412001791, 1327, 1373, 290, 303
sanysidro060-2010.png, 2267, 4220, 6487, 655, 0.201942346231, 761, 795, 146, 191
sanysidro061-2010.png, 1917, 3429, 5346, 588, 0.219977553311, 688, 717, 172, 166
sanysidro062-2010.png, 515, 2139, 2654, 104, 0.0783722682743, 126, 160, 36, 49
sanysidro063-2010.png, 1693, 2313, 4006, 396, 0.197703444833, 472, 475, 111, 100
sanysidro064-2010.png, 2491, 3760, 6251, 1265, 0.404735242361, 1412, 1468, 177, 188
yuba001-2010.png, 1983, 3982, 5965, 691, 0.231684828164, 793, 908, 167, 207
yuba002-2010.png, 2531, 4733, 7264, 1522, 0.419052863436, 1670, 1807, 175, 216
yuba003-2010.png, 1461, 2647, 4108, 627, 0.305258033106, 710, 785, 114, 132
yuba004-2010.png, 1974, 3107, 5081, 900, 0.35426097225, 1001, 1064, 142, 155
yuba005-2010.png, 882, 1337, 2219, 410, 0.369535826949, 498, 539, 97, 97
yuba006-2010.png, 1318, 1847, 3165, 454, 0.286887835703, 552, 582, 115, 129
yuba007-2010.png, 1228, 1265, 2493, 375, 0.300842358604, 484, 498, 107, 103
yuba008-2010.png, 779, 676, 1455, 192, 0.263917525773, 270, 259, 71, 80
yuba009-2010.png, 1916, 4312, 6228, 786, 0.252408477842, 900, 1021, 156, 211
yuba010-2010.png, 2560, 4917, 7477, 1421, 0.380098970175, 1561, 1653, 144, 207
yuba011-2010.png, 1883, 3306, 5189, 788, 0.303719406437, 915, 970, 166, 174
yuba012-2010.png, 2525, 4000, 6525, 1349, 0.413486590038, 1466, 1575, 165, 194
yuba013-2010.png, 1596, 2306, 3902, 654, 0.33521271143, 750, 780, 121, 114
yuba014-2010.png, 1001, 1566, 2567, 493, 0.384105960265, 589, 643, 106, 114
yuba015-2010.png, 1001, 1250, 2251, 356, 0.316303864949, 444, 476, 96, 106
yuba016-2010.png, 1024, 499, 1523, 117, 0.153644123441, 169, 142, 43, 27
yuba017-2010.png, 1953, 3626, 5579, 971, 0.348091055745, 1108, 1170, 148, 157
yuba018-2010.png, 2732, 5092, 7824, 1543, 0.394427402863, 1701, 1762, 158, 200
yuba019-2010.png, 2714, 4358, 7072, 1441, 0.407522624434, 1560, 1642, 176, 198
yuba020-2010.png, 1286, 2674, 3960, 794, 0.40101010101, 875, 961, 96, 119
yuba021-2010.png, 1353, 2372, 3725, 591, 0.317315436242, 690, 757, 103, 136
yuba022-2010.png, 1064, 1683, 2747, 372, 0.270840917364, 467, 491, 86, 82
yuba023-2010.png, 617, 1042, 1659, 275, 0.331525015069, 319, 364, 48, 73
yuba024-2010.png, 1555, 911, 2466, 222, 0.1800486618, 297, 267, 70, 57
yuba025-2010.png, 1865, 4188, 6053, 784, 0.259045101603, 867, 995, 130, 179
yuba026-2010.png, 1344, 3137, 4481, 713, 0.31823253738, 801, 906, 105, 134
yuba027-2010.png, 2404, 3572, 5976, 1001, 0.33500669344, 1110, 1199, 148, 165
yuba028-2010.png, 1543, 2759, 4302, 779, 0.362157136216, 880, 949, 93, 124
yuba029-2010.png, 1070, 2269, 3339, 657, 0.393530997305, 748, 808, 109, 109
yuba030-2010.png, 1486, 2351, 3837, 563, 0.293458431066, 663, 723, 121, 139
yuba031-2010.png, 1549, 2114, 3663, 552, 0.301392301392, 665, 712, 114, 122
yuba032-2010.png, 996, 644, 1640, 135, 0.164634146341, 179, 172, 41, 32
yuba033-2010.png, 876, 1563, 2439, 344, 0.282082820828, 396, 441, 76, 101
yuba034-2010.png, 903, 2202, 3105, 406, 0.261513687601, 472, 539, 68, 86
yuba035-2010.png, 1528, 1991, 3519, 847, 0.481386757602, 954, 978, 94, 111
yuba036-2010.png, 750, 1244, 1994, 391, 0.392176529589, 452, 490, 50, 54
yuba037-2010.png, 2111, 3149, 5260, 776, 0.295057034221, 885, 931, 154, 174
yuba038-2010.png, 2265, 3486, 5751, 712, 0.247609111459, 834, 877, 168, 182
yuba039-2010.png, 2090, 3158, 5248, 902, 0.34375, 1033, 1063, 157, 160
yuba040-2010.png, 1783, 2586, 4369, 470, 0.215152208743, 539, 589, 101, 106
yuba041-2010.png, 843, 1669, 2512, 319, 0.25398089172, 385, 418, 85, 79
yuba042-2010.png, 913, 1861, 2774, 463, 0.333813987022, 540, 604, 84, 104
yuba043-2010.png, 1325, 1713, 3038, 549, 0.36142198815, 638, 694, 107, 106
yuba044-2010.png, 693, 703, 1396, 262, 0.375358166189, 325, 317, 43, 43
yuba045-2010.png, 1310, 1703, 3013, 579, 0.384334550282, 676, 723, 111, 137
yuba046-2010.png, 1996, 2588, 4584, 569, 0.248254799302, 681, 712, 121, 116
yuba047-2010.png, 2377, 3582, 5959, 1107, 0.3715388488, 1233, 1299, 192, 187
yuba048-2010.png, 2555, 3871, 6426, 862, 0.268285091815, 975, 1050, 171, 183
yuba049-2010.png, 1451, 2315, 3766, 606, 0.321826872013, 713, 774, 122, 119
yuba050-2010.png, 1198, 2294, 3492, 561, 0.321305841924, 635, 720, 95, 109
yuba051-2010.png, 1389, 1798, 3187, 526, 0.330090994666, 618, 669, 99, 120
yuba052-2010.png, 959, 1055, 2014, 415, 0.412115193644, 501, 503, 77, 79
yuba053-2010.png, 1351, 1575, 2926, 442, 0.302118933698, 553, 570, 105, 107
yuba054-2010.png, 1214, 1614, 2828, 533, 0.376944837341, 659, 684, 135, 147
yuba055-2010.png, 1248, 1748, 2996, 491, 0.327770360481, 580, 603, 85, 92
yuba056-2010.png, 1319, 2718, 4037, 616, 0.305177111717, 691, 774, 96, 132
yuba057-2010.png, 1448, 2411, 3859, 548, 0.284011401918, 662, 724, 128, 124
yuba058-2010.png, 907, 1718, 2625, 274, 0.208761904762, 325, 353, 51, 60
yuba059-2010.png, 1463, 1922, 3385, 581, 0.343279172821, 710, 736, 112, 127
yuba060-2010.png, 977, 1247, 2224, 362, 0.325539568345, 435, 460, 72, 102
yuba061-2010.png, 1286, 1363, 2649, 579, 0.437146092865, 705, 723, 113, 112
yuba062-2010.png, 1602, 2353, 3955, 656, 0.331731984829, 770, 821, 138, 139
yuba063-2010.png, 1092, 1348, 2440, 452, 0.370491803279, 558, 594, 95, 94
yuba064-2010.png, 1776, 2729, 4505, 787, 0.349389567148, 902, 935, 124, 127
