Filename, N_kps1, N_kps2, Total_kps2, N_matches, average_match_rate, n_forward, n_backward, n_not_first_match_forward, n_not_first_match_backward
jenner001-2010.png, 1336, 1690, 3026, 283, 0.187045604759, 335, 349, 0, 0
jenner002-2010.png, 1386, 1736, 3122, 329, 0.210762331839, 380, 397, 0, 0
jenner003-2010.png, 1994, 1914, 3908, 423, 0.2164790174, 508, 539, 0, 0
jenner004-2010.png, 869, 966, 1835, 315, 0.343324250681, 357, 377, 0, 0
jenner005-2010.png, 854, 1209, 2063, 158, 0.153174987882, 183, 197, 0, 0
jenner006-2010.png, 1570, 2199, 3769, 933, 0.495091536217, 1020, 1063, 0, 0
jenner007-2010.png, 1250, 2001, 3251, 628, 0.386342663796, 716, 742, 0, 0
jenner008-2010.png, 2150, 3346, 5496, 948, 0.344978165939, 1057, 1128, 0, 0
jenner009-2010.png, 840, 1123, 1963, 342, 0.348446255731, 402, 405, 0, 0
jenner010-2010.png, 724, 974, 1698, 152, 0.179034157833, 186, 197, 0, 0
jenner011-2010.png, 890, 753, 1643, 157, 0.19111381619, 199, 190, 0, 0
jenner012-2010.png, 1523, 1986, 3509, 593, 0.337988030778, 665, 694, 0, 0
jenner013-2010.png, 1636, 2200, 3836, 544, 0.283628779979, 630, 632, 0, 0
jenner014-2010.png, 1337, 1361, 2698, 370, 0.274277242402, 420, 456, 0, 0
jenner015-2010.png, 1017, 1080, 2097, 420, 0.400572246066, 474, 466, 0, 0
jenner016-2010.png, 1309, 2044, 3353, 602, 0.359081419624, 674, 718, 0, 0
jenner017-2010.png, 1228, 1132, 2360, 455, 0.385593220339, 508, 536, 0, 0
jenner018-2010.png, 1348, 1743, 3091, 462, 0.298932384342, 517, 542, 0, 0
jenner019-2010.png, 1478, 1297, 2775, 131, 0.0944144144144, 175, 180, 0, 0
jenner020-2010.png, 989, 1401, 2390, 417, 0.348953974895, 467, 486, 0, 0
jenner021-2010.png, 1476, 2268, 3744, 473, 0.252670940171, 539, 581, 0, 0
jenner022-2010.png, 1415, 1433, 2848, 431, 0.302668539326, 491, 500, 0, 0
jenner023-2010.png, 1072, 1226, 2298, 538, 0.468233246301, 611, 617, 0, 0
jenner024-2010.png, 1623, 2474, 4097, 863, 0.421283866244, 967, 991, 0, 0
jenner025-2010.png, 2194, 2647, 4841, 1216, 0.502375542243, 1312, 1364, 0, 0
jenner026-2010.png, 1318, 1739, 3057, 417, 0.272816486752, 476, 484, 0, 0
jenner027-2010.png, 1992, 2366, 4358, 595, 0.273061037173, 680, 689, 0, 0
jenner028-2010.png, 636, 714, 1350, 151, 0.223703703704, 177, 185, 0, 0
jenner029-2010.png, 1944, 2932, 4876, 967, 0.396636587367, 1067, 1115, 0, 0
jenner030-2010.png, 1420, 2233, 3653, 736, 0.402956474131, 804, 848, 0, 0
jenner031-2010.png, 1327, 1958, 3285, 670, 0.407914764079, 726, 761, 0, 0
jenner032-2010.png, 1806, 2410, 4216, 893, 0.423624288425, 991, 1033, 0, 0
jenner033-2010.png, 1759, 2209, 3968, 865, 0.435987903226, 946, 976, 0, 0
jenner034-2010.png, 1742, 2115, 3857, 520, 0.269639616282, 578, 602, 0, 0
jenner035-2010.png, 2048, 2334, 4382, 764, 0.348699224099, 854, 885, 0, 0
jenner036-2010.png, 883, 1350, 2233, 366, 0.327810120914, 404, 442, 0, 0
jenner037-2010.png, 1329, 2112, 3441, 571, 0.331880267364, 639, 675, 0, 0
jenner038-2010.png, 1001, 1637, 2638, 479, 0.363153904473, 531, 571, 0, 0
jenner039-2010.png, 483, 732, 1215, 205, 0.337448559671, 242, 244, 0, 0
jenner040-2010.png, 1013, 1391, 2404, 445, 0.370216306156, 485, 520, 0, 0
jenner041-2010.png, 1641, 1929, 3570, 634, 0.355182072829, 696, 719, 0, 0
jenner042-2010.png, 2083, 3109, 5192, 973, 0.374807395994, 1074, 1143, 0, 0
jenner043-2010.png, 1566, 1872, 3438, 582, 0.338568935428, 671, 668, 0, 0
jenner044-2010.png, 1060, 1458, 2518, 480, 0.381254964257, 530, 560, 0, 0
jenner045-2010.png, 1221, 1880, 3101, 519, 0.334730732022, 567, 617, 0, 0
jenner046-2010.png, 1455, 2268, 3723, 941, 0.505506312114, 1009, 1054, 0, 0
jenner047-2010.png, 933, 1426, 2359, 398, 0.337431114879, 438, 483, 0, 0
jenner048-2010.png, 1545, 2294, 3839, 774, 0.403230007815, 854, 902, 0, 0
jenner049-2010.png, 1240, 1826, 3066, 530, 0.345727332029, 572, 616, 0, 0
jenner050-2010.png, 1372, 2260, 3632, 627, 0.345264317181, 706, 733, 0, 0
jenner051-2010.png, 1050, 1389, 2439, 353, 0.289462894629, 405, 423, 0, 0
jenner052-2010.png, 948, 1388, 2336, 562, 0.481164383562, 609, 633, 0, 0
jenner053-2010.png, 984, 1586, 2570, 418, 0.325291828794, 475, 499, 0, 0
jenner054-2010.png, 943, 1055, 1998, 409, 0.409409409409, 466, 460, 0, 0
jenner055-2010.png, 714, 1053, 1767, 334, 0.378041878891, 377, 378, 0, 0
jenner056-2010.png, 863, 893, 1756, 259, 0.294988610478, 300, 303, 0, 0
jenner057-2010.png, 1414, 1895, 3309, 709, 0.428528256271, 780, 797, 0, 0
jenner058-2010.png, 1251, 2338, 3589, 606, 0.337698523266, 661, 721, 0, 0
jenner059-2010.png, 1383, 1845, 3228, 647, 0.400867410161, 720, 732, 0, 0
jenner060-2010.png, 728, 911, 1639, 296, 0.361195851129, 334, 345, 0, 0
jenner061-2010.png, 661, 891, 1552, 172, 0.221649484536, 204, 223, 0, 0
jenner062-2010.png, 529, 689, 1218, 209, 0.343185550082, 239, 242, 0, 0
jenner063-2010.png, 1006, 1422, 2428, 475, 0.391268533773, 527, 545, 0, 0
jenner064-2010.png, 984, 1097, 2081, 331, 0.318116290245, 400, 393, 0, 0
losangeles001-2010.png, 2812, 4486, 7298, 766, 0.209920526172, 896, 917, 0, 0
losangeles002-2010.png, 2723, 5495, 8218, 931, 0.226575809199, 1042, 1099, 0, 0
losangeles003-2010.png, 1099, 4306, 5405, 529, 0.195744680851, 597, 635, 0, 0
losangeles004-2010.png, 765, 3621, 4386, 210, 0.0957592339261, 257, 284, 0, 0
losangeles005-2010.png, 1090, 4385, 5475, 513, 0.187397260274, 552, 623, 0, 0
losangeles006-2010.png, 1398, 4589, 5987, 705, 0.235510272257, 766, 829, 0, 0
losangeles007-2010.png, 2011, 4605, 6616, 1144, 0.345828295042, 1261, 1300, 0, 0
losangeles008-2010.png, 1740, 4585, 6325, 1046, 0.330750988142, 1118, 1177, 0, 0
losangeles009-2010.png, 2437, 5374, 7811, 771, 0.197413903469, 880, 962, 0, 0
losangeles010-2010.png, 2584, 5039, 7623, 1158, 0.303817394726, 1253, 1301, 0, 0
losangeles011-2010.png, 1183, 4625, 5808, 673, 0.231749311295, 725, 772, 0, 0
losangeles012-2010.png, 1815, 4450, 6265, 952, 0.303910614525, 1051, 1142, 0, 0
losangeles013-2010.png, 1355, 4644, 5999, 753, 0.251041840307, 816, 893, 0, 0
losangeles014-2010.png, 2096, 5013, 7109, 1215, 0.34182022788, 1326, 1354, 0, 0
losangeles015-2010.png, 1163, 3053, 4216, 679, 0.32210626186, 730, 796, 0, 0
losangeles016-2010.png, 1329, 4377, 5706, 691, 0.242201191728, 753, 794, 0, 0
losangeles017-2010.png, 2882, 5009, 7891, 781, 0.19794702826, 931, 949, 0, 0
losangeles018-2010.png, 3039, 4381, 7420, 1507, 0.406199460916, 1640, 1667, 0, 0
losangeles019-2010.png, 1164, 3885, 5049, 683, 0.27054862349, 736, 797, 0, 0
losangeles020-2010.png, 1587, 3961, 5548, 742, 0.267483777938, 834, 867, 0, 0
losangeles021-2010.png, 1923, 4336, 6259, 960, 0.306758268094, 1060, 1081, 0, 0
losangeles022-2010.png, 1996, 5029, 7025, 1116, 0.317722419929, 1210, 1292, 0, 0
losangeles023-2010.png, 1303, 4360, 5663, 799, 0.282182588734, 854, 900, 0, 0
losangeles024-2010.png, 2064, 4942, 7006, 1090, 0.311161861262, 1178, 1222, 0, 0
losangeles025-2010.png, 2458, 4944, 7402, 620, 0.167522291273, 726, 780, 0, 0
losangeles026-2010.png, 2706, 4682, 7388, 1302, 0.35246345425, 1445, 1485, 0, 0
losangeles027-2010.png, 1506, 4338, 5844, 848, 0.290212183436, 925, 984, 0, 0
losangeles028-2010.png, 1457, 4158, 5615, 824, 0.293499554764, 896, 948, 0, 0
losangeles029-2010.png, 2505, 4529, 7034, 1449, 0.411998862667, 1568, 1611, 0, 0
losangeles030-2010.png, 1972, 4783, 6755, 1062, 0.314433752776, 1135, 1181, 0, 0
losangeles031-2010.png, 2058, 4444, 6502, 1112, 0.342048600431, 1188, 1247, 0, 0
losangeles032-2010.png, 1994, 4683, 6677, 1099, 0.329189755878, 1183, 1238, 0, 0
losangeles033-2010.png, 3249, 5152, 8401, 982, 0.233781692656, 1136, 1200, 0, 0
losangeles034-2010.png, 3019, 5148, 8167, 745, 0.182441532999, 889, 909, 0, 0
losangeles035-2010.png, 1434, 4312, 5746, 763, 0.265576052906, 829, 884, 0, 0
losangeles036-2010.png, 1587, 4362, 5949, 817, 0.27466801143, 892, 927, 0, 0
losangeles037-2010.png, 1793, 4420, 6213, 962, 0.309673265733, 1030, 1109, 0, 0
losangeles038-2010.png, 1836, 4610, 6446, 1000, 0.310269934843, 1095, 1171, 0, 0
losangeles039-2010.png, 2320, 4687, 7007, 1394, 0.397887826459, 1497, 1562, 0, 0
losangeles040-2010.png, 2130, 4472, 6602, 1258, 0.381096637383, 1352, 1388, 0, 0
losangeles041-2010.png, 3502, 5443, 8945, 784, 0.175293460034, 928, 949, 0, 0
losangeles042-2010.png, 3213, 4600, 7813, 1217, 0.311532061948, 1342, 1364, 0, 0
losangeles043-2010.png, 1554, 4023, 5577, 801, 0.287251210328, 881, 936, 0, 0
losangeles044-2010.png, 1074, 4263, 5337, 470, 0.176128911373, 512, 564, 0, 0
losangeles045-2010.png, 1820, 4636, 6456, 862, 0.267038413879, 964, 985, 0, 0
losangeles046-2010.png, 1928, 4482, 6410, 996, 0.310764430577, 1067, 1111, 0, 0
losangeles047-2010.png, 2160, 4525, 6685, 1298, 0.388332086761, 1405, 1462, 0, 0
losangeles048-2010.png, 1770, 4411, 6181, 901, 0.291538585989, 974, 1009, 0, 0
losangeles049-2010.png, 3454, 5237, 8691, 743, 0.170981475089, 908, 896, 0, 0
losangeles050-2010.png, 3032, 4264, 7296, 1477, 0.404879385965, 1606, 1633, 0, 0
losangeles051-2010.png, 1732, 4374, 6106, 886, 0.290206354406, 952, 1009, 0, 0
losangeles052-2010.png, 1759, 4741, 6500, 933, 0.287076923077, 1012, 1050, 0, 0
losangeles053-2010.png, 2388, 4513, 6901, 1220, 0.353571946095, 1333, 1354, 0, 0
losangeles054-2010.png, 2707, 4884, 7591, 1561, 0.411276511659, 1677, 1696, 0, 0
losangeles055-2010.png, 2183, 4330, 6513, 1337, 0.410563488408, 1413, 1472, 0, 0
losangeles056-2010.png, 1956, 4050, 6006, 970, 0.32301032301, 1059, 1111, 0, 0
losangeles057-2010.png, 3198, 5004, 8202, 843, 0.205559619605, 982, 1029, 0, 0
losangeles058-2010.png, 2891, 4572, 7463, 1052, 0.281924159185, 1153, 1188, 0, 0
losangeles059-2010.png, 1694, 4513, 6207, 677, 0.218140808764, 735, 832, 0, 0
losangeles060-2010.png, 2038, 4842, 6880, 1010, 0.293604651163, 1088, 1161, 0, 0
losangeles061-2010.png, 2186, 4729, 6915, 1090, 0.315256688359, 1190, 1241, 0, 0
losangeles062-2010.png, 2327, 4639, 6966, 1220, 0.350272753374, 1317, 1340, 0, 0
losangeles063-2010.png, 1800, 4148, 5948, 947, 0.318426361802, 1030, 1087, 0, 0
losangeles064-2010.png, 2102, 4384, 6486, 1050, 0.323774283071, 1141, 1200, 0, 0
merced001-2010.png, 3139, 5248, 8387, 1211, 0.288780255157, 1321, 1383, 0, 0
merced002-2010.png, 2814, 4640, 7454, 733, 0.196672927287, 823, 887, 0, 0
merced003-2010.png, 840, 1557, 2397, 305, 0.254484772632, 358, 392, 0, 0
merced004-2010.png, 1189, 1857, 3046, 451, 0.296126066973, 530, 569, 0, 0
merced005-2010.png, 664, 1115, 1779, 205, 0.230466554244, 232, 263, 0, 0
merced006-2010.png, 373, 741, 1114, 68, 0.122082585278, 86, 106, 0, 0
merced007-2010.png, 381, 695, 1076, 48, 0.089219330855, 58, 69, 0, 0
merced008-2010.png, 342, 307, 649, 33, 0.101694915254, 49, 45, 0, 0
merced009-2010.png, 1935, 4787, 6722, 762, 0.226718238619, 845, 904, 0, 0
merced010-2010.png, 1661, 4436, 6097, 512, 0.167951451534, 582, 658, 0, 0
merced011-2010.png, 871, 1275, 2146, 105, 0.0978564771668, 128, 161, 0, 0
merced012-2010.png, 986, 1650, 2636, 292, 0.221547799697, 371, 391, 0, 0
merced013-2010.png, 777, 1033, 1810, 142, 0.156906077348, 196, 206, 0, 0
merced014-2010.png, 997, 1557, 2554, 200, 0.156617071261, 243, 279, 0, 0
merced015-2010.png, 377, 1515, 1892, 144, 0.15221987315, 163, 201, 0, 0
merced016-2010.png, 556, 935, 1491, 223, 0.299128101945, 272, 276, 0, 0
merced017-2010.png, 731, 2268, 2999, 152, 0.101367122374, 179, 223, 0, 0
merced018-2010.png, 1141, 2128, 3269, 188, 0.115019883757, 223, 260, 0, 0
merced019-2010.png, 708, 1098, 1806, 21, 0.0232558139535, 31, 58, 0, 0
merced020-2010.png, 601, 685, 1286, 140, 0.217729393468, 178, 172, 0, 0
merced021-2010.png, 849, 400, 1249, 32, 0.0512409927942, 60, 48, 0, 0
merced022-2010.png, 876, 508, 1384, 132, 0.190751445087, 168, 158, 0, 0
merced023-2010.png, 691, 860, 1551, 141, 0.181818181818, 182, 221, 0, 0
merced024-2010.png, 275, 692, 967, 53, 0.10961737332, 78, 90, 0, 0
merced025-2010.png, 677, 1549, 2226, 114, 0.102425876011, 142, 176, 0, 0
merced026-2010.png, 1237, 1570, 2807, 296, 0.210901318133, 353, 373, 0, 0
merced027-2010.png, 1365, 1716, 3081, 119, 0.0772476468679, 176, 168, 0, 0
merced028-2010.png, 605, 367, 972, 44, 0.0905349794239, 69, 62, 0, 0
merced029-2010.png, 1354, 93, 1447, 12, 0.0165860400829, 27, 15, 0, 0
merced030-2010.png, 1395, 93, 1488, 16, 0.0215053763441, 39, 18, 0, 0
merced031-2010.png, 543, 385, 928, 130, 0.280172413793, 171, 164, 0, 0
merced032-2010.png, 271, 187, 458, 20, 0.0873362445415, 34, 26, 0, 0
merced033-2010.png, 1325, 1711, 3036, 374, 0.246376811594, 458, 479, 0, 0
merced034-2010.png, 1288, 1745, 3033, 154, 0.101549620837, 198, 227, 0, 0
merced035-2010.png, 565, 400, 965, 50, 0.103626943005, 88, 71, 0, 0
merced036-2010.png, 1473, 437, 1910, 164, 0.171727748691, 224, 191, 0, 0
merced037-2010.png, 2501, 496, 2997, 196, 0.130797464131, 271, 221, 0, 0
merced038-2010.png, 1461, 83, 1544, 20, 0.0259067357513, 41, 23, 0, 0
merced039-2010.png, 618, 235, 853, 67, 0.157092614302, 102, 77, 0, 0
merced040-2010.png, 706, 396, 1102, 39, 0.070780399274, 61, 50, 0, 0
merced041-2010.png, 1200, 1569, 2769, 424, 0.306247742867, 519, 511, 0, 0
merced042-2010.png, 1175, 878, 2053, 68, 0.0662445202143, 113, 102, 0, 0
merced043-2010.png, 1160, 126, 1286, 46, 0.0715396578538, 76, 52, 0, 0
merced044-2010.png, 1606, 345, 1951, 50, 0.0512557662737, 94, 62, 0, 0
merced045-2010.png, 3044, 386, 3430, 165, 0.0962099125364, 251, 182, 0, 0
merced046-2010.png, 1927, 183, 2110, 61, 0.0578199052133, 107, 67, 0, 0
merced047-2010.png, 1019, 422, 1441, 195, 0.270645385149, 242, 213, 0, 0
merced048-2010.png, 979, 1226, 2205, 102, 0.0925170068027, 131, 146, 0, 0
merced049-2010.png, 529, 1152, 1681, 172, 0.204640095181, 217, 226, 0, 0
merced050-2010.png, 551, 171, 722, 35, 0.0969529085873, 63, 47, 0, 0
merced051-2010.png, 1269, 214, 1483, 28, 0.037761294673, 52, 42, 0, 0
merced052-2010.png, 2207, 290, 2497, 50, 0.0400480576692, 84, 61, 0, 0
merced053-2010.png, 2051, 176, 2227, 26, 0.0233497979344, 59, 29, 0, 0
merced054-2010.png, 1768, 125, 1893, 22, 0.0232435287903, 46, 27, 0, 0
merced055-2010.png, 600, 155, 755, 41, 0.108609271523, 58, 48, 0, 0
merced056-2010.png, 717, 853, 1570, 45, 0.0573248407643, 62, 71, 0, 0
merced057-2010.png, 600, 566, 1166, 55, 0.0943396226415, 80, 76, 0, 0
merced058-2010.png, 422, 84, 506, 17, 0.0671936758893, 30, 23, 0, 0
merced059-2010.png, 883, 180, 1063, 30, 0.0564440263405, 51, 35, 0, 0
merced060-2010.png, 1216, 218, 1434, 7, 0.00976290097629, 21, 14, 0, 0
merced061-2010.png, 913, 388, 1301, 38, 0.0584166026134, 58, 52, 0, 0
merced062-2010.png, 1272, 170, 1442, 50, 0.0693481276006, 91, 57, 0, 0
merced063-2010.png, 1486, 218, 1704, 45, 0.0528169014085, 71, 55, 0, 0
merced064-2010.png, 1155, 895, 2050, 98, 0.0956097560976, 142, 139, 0, 0
oakland001-2010.png, 2761, 3106, 5867, 588, 0.200443156639, 690, 698, 0, 0
oakland002-2010.png, 3590, 4300, 7890, 589, 0.149302915082, 692, 708, 0, 0
oakland003-2010.png, 3460, 4864, 8324, 1550, 0.37241710716, 1694, 1738, 0, 0
oakland004-2010.png, 3260, 5011, 8271, 1574, 0.380606939911, 1754, 1792, 0, 0
oakland005-2010.png, 2599, 3707, 6306, 1023, 0.324452901998, 1111, 1179, 0, 0
oakland006-2010.png, 1301, 1511, 2812, 244, 0.173541963016, 293, 292, 0, 0
oakland007-2010.png, 1248, 2502, 3750, 587, 0.313066666667, 671, 737, 0, 0
oakland008-2010.png, 1552, 2610, 4162, 1077, 0.517539644402, 1154, 1237, 0, 0
oakland009-2010.png, 2408, 2774, 5182, 424, 0.163643380934, 513, 541, 0, 0
oakland010-2010.png, 3091, 4535, 7626, 1235, 0.323891948597, 1360, 1428, 0, 0
oakland011-2010.png, 2488, 4848, 7336, 918, 0.250272628135, 1026, 1085, 0, 0
oakland012-2010.png, 2823, 4897, 7720, 838, 0.217098445596, 959, 1035, 0, 0
oakland013-2010.png, 1975, 1845, 3820, 173, 0.0905759162304, 210, 219, 0, 0
oakland014-2010.png, 1474, 1892, 3366, 480, 0.285204991087, 540, 584, 0, 0
oakland015-2010.png, 2082, 3725, 5807, 1179, 0.406061649733, 1269, 1362, 0, 0
oakland016-2010.png, 1570, 2643, 4213, 933, 0.442914787562, 1016, 1082, 0, 0
oakland017-2010.png, 2838, 3368, 6206, 557, 0.179503706091, 656, 665, 0, 0
oakland018-2010.png, 2784, 4825, 7609, 1177, 0.309370482324, 1285, 1366, 0, 0
oakland019-2010.png, 2598, 4827, 7425, 1066, 0.287138047138, 1162, 1240, 0, 0
oakland020-2010.png, 2825, 4276, 7101, 533, 0.15011970145, 621, 672, 0, 0
oakland021-2010.png, 2126, 3047, 5173, 727, 0.281074811521, 826, 859, 0, 0
oakland022-2010.png, 3430, 4845, 8275, 1629, 0.393716012085, 1767, 1848, 0, 0
oakland023-2010.png, 2786, 4532, 7318, 1591, 0.434818256354, 1725, 1808, 0, 0
oakland024-2010.png, 1531, 2754, 4285, 904, 0.421936989498, 978, 1022, 0, 0
oakland025-2010.png, 3377, 4296, 7673, 974, 0.253877231852, 1114, 1173, 0, 0
oakland026-2010.png, 3570, 5074, 8644, 1490, 0.344747801944, 1610, 1655, 0, 0
oakland027-2010.png, 2359, 3418, 5777, 562, 0.194564652934, 647, 713, 0, 0
oakland028-2010.png, 1889, 2822, 4711, 498, 0.211420080662, 557, 621, 0, 0
oakland029-2010.png, 3004, 4369, 7373, 1162, 0.315204123152, 1290, 1346, 0, 0
oakland030-2010.png, 3120, 4352, 7472, 1567, 0.41943254818, 1731, 1758, 0, 0
oakland031-2010.png, 1328, 2739, 4067, 742, 0.364888123924, 828, 862, 0, 0
oakland032-2010.png, 2926, 4793, 7719, 1740, 0.450835600466, 1874, 1935, 0, 0
oakland033-2010.png, 2953, 4769, 7722, 867, 0.224553224553, 984, 1058, 0, 0
oakland034-2010.png, 2399, 5176, 7575, 1003, 0.264818481848, 1080, 1139, 0, 0
oakland035-2010.png, 3120, 3598, 6718, 858, 0.255433164632, 1003, 1035, 0, 0
oakland036-2010.png, 2624, 3812, 6436, 775, 0.240832815413, 859, 939, 0, 0
oakland037-2010.png, 3078, 4962, 8040, 1353, 0.336567164179, 1499, 1548, 0, 0
oakland038-2010.png, 2036, 3732, 5768, 1095, 0.379680998613, 1193, 1289, 0, 0
oakland039-2010.png, 3112, 4868, 7980, 1847, 0.46290726817, 1964, 2060, 0, 0
oakland040-2010.png, 3026, 5197, 8223, 1782, 0.433418460416, 1884, 1957, 0, 0
oakland041-2010.png, 2623, 4720, 7343, 882, 0.240228789323, 988, 1062, 0, 0
oakland042-2010.png, 2242, 3661, 5903, 573, 0.194138573607, 638, 717, 0, 0
oakland043-2010.png, 2775, 2958, 5733, 1081, 0.377114948544, 1175, 1219, 0, 0
oakland044-2010.png, 2789, 3620, 6409, 1169, 0.364799500702, 1317, 1340, 0, 0
oakland045-2010.png, 3397, 5065, 8462, 1087, 0.256913259277, 1215, 1284, 0, 0
oakland046-2010.png, 2852, 4392, 7244, 1153, 0.318332413031, 1269, 1353, 0, 0
oakland047-2010.png, 2598, 4121, 6719, 1436, 0.427444560202, 1533, 1635, 0, 0
oakland048-2010.png, 2666, 4838, 7504, 1627, 0.433635394456, 1739, 1804, 0, 0
oakland049-2010.png, 3040, 3930, 6970, 714, 0.20487804878, 811, 856, 0, 0
oakland050-2010.png, 1417, 2068, 3485, 239, 0.137159253945, 279, 329, 0, 0
oakland051-2010.png, 1941, 2190, 4131, 495, 0.239651416122, 582, 604, 0, 0
oakland052-2010.png, 1613, 2367, 3980, 455, 0.22864321608, 534, 558, 0, 0
oakland053-2010.png, 2172, 3033, 5205, 752, 0.288952929875, 853, 906, 0, 0
oakland054-2010.png, 1918, 2677, 4595, 768, 0.334276387378, 871, 893, 0, 0
oakland055-2010.png, 2938, 4189, 7127, 1629, 0.457134839343, 1769, 1822, 0, 0
oakland056-2010.png, 2645, 5267, 7912, 1682, 0.425176946411, 1786, 1879, 0, 0
oakland057-2010.png, 1357, 1857, 3214, 222, 0.138145612943, 276, 307, 0, 0
oakland058-2010.png, 2052, 2483, 4535, 464, 0.204630650496, 539, 578, 0, 0
oakland059-2010.png, 1907, 2224, 4131, 578, 0.279835390947, 669, 709, 0, 0
oakland060-2010.png, 2099, 2694, 4793, 520, 0.216983100355, 601, 631, 0, 0
oakland061-2010.png, 2383, 3470, 5853, 922, 0.315052110029, 1043, 1100, 0, 0
oakland062-2010.png, 1457, 2531, 3988, 657, 0.329488465396, 721, 793, 0, 0
oakland063-2010.png, 1971, 3126, 5097, 1037, 0.406906023151, 1141, 1203, 0, 0
oakland064-2010.png, 2435, 5274, 7709, 1402, 0.363730704372, 1494, 1555, 0, 0
petaluma001-2010.png, 1811, 2427, 4238, 900, 0.424728645588, 987, 1022, 0, 0
petaluma002-2010.png, 3229, 4499, 7728, 1731, 0.44798136646, 1863, 1918, 0, 0
petaluma003-2010.png, 1388, 2715, 4103, 584, 0.284669753839, 656, 680, 0, 0
petaluma004-2010.png, 1507, 2060, 3567, 208, 0.116624614522, 277, 286, 0, 0
petaluma005-2010.png, 1395, 1631, 3026, 210, 0.13879709187, 258, 267, 0, 0
petaluma006-2010.png, 1005, 1282, 2287, 195, 0.170529077394, 242, 263, 0, 0
petaluma007-2010.png, 1851, 2548, 4399, 591, 0.268697431234, 689, 715, 0, 0
petaluma008-2010.png, 1257, 2298, 3555, 212, 0.119268635724, 253, 285, 0, 0
petaluma009-2010.png, 3558, 4681, 8239, 1646, 0.399563053769, 1792, 1829, 0, 0
petaluma010-2010.png, 3095, 4478, 7573, 1621, 0.428099828338, 1754, 1798, 0, 0
petaluma011-2010.png, 2531, 4316, 6847, 1223, 0.35723674602, 1347, 1373, 0, 0
petaluma012-2010.png, 1017, 1718, 2735, 89, 0.0650822669104, 105, 127, 0, 0
petaluma013-2010.png, 990, 1505, 2495, 68, 0.0545090180361, 82, 97, 0, 0
petaluma014-2010.png, 1713, 2394, 4107, 537, 0.261504747991, 626, 615, 0, 0
petaluma015-2010.png, 1289, 1938, 3227, 434, 0.268980477223, 494, 534, 0, 0
petaluma016-2010.png, 1447, 2167, 3614, 369, 0.204205866076, 439, 445, 0, 0
petaluma017-2010.png, 3235, 4828, 8063, 1437, 0.356443011286, 1569, 1631, 0, 0
petaluma018-2010.png, 2911, 4583, 7494, 1343, 0.358420069389, 1459, 1517, 0, 0
petaluma019-2010.png, 1765, 3305, 5070, 752, 0.296646942801, 831, 880, 0, 0
petaluma020-2010.png, 1659, 2243, 3902, 341, 0.174782162993, 423, 416, 0, 0
petaluma021-2010.png, 1750, 1978, 3728, 479, 0.256974248927, 553, 561, 0, 0
petaluma022-2010.png, 2460, 3119, 5579, 1243, 0.445599569815, 1375, 1390, 0, 0
petaluma023-2010.png, 1662, 2260, 3922, 437, 0.222845486996, 506, 544, 0, 0
petaluma024-2010.png, 2001, 2933, 4934, 572, 0.231860559384, 676, 707, 0, 0
petaluma025-2010.png, 2730, 3766, 6496, 1230, 0.378694581281, 1364, 1387, 0, 0
petaluma026-2010.png, 1867, 2920, 4787, 580, 0.242322958011, 662, 696, 0, 0
petaluma027-2010.png, 1388, 2002, 3390, 468, 0.27610619469, 535, 575, 0, 0
petaluma028-2010.png, 1939, 2473, 4412, 411, 0.186310063463, 503, 511, 0, 0
petaluma029-2010.png, 2285, 2914, 5199, 1085, 0.417387959223, 1207, 1223, 0, 0
petaluma030-2010.png, 1887, 2674, 4561, 767, 0.336329752247, 871, 863, 0, 0
petaluma031-2010.png, 1243, 2409, 3652, 301, 0.164841182913, 356, 399, 0, 0
petaluma032-2010.png, 2446, 3922, 6368, 664, 0.208542713568, 773, 804, 0, 0
petaluma033-2010.png, 2723, 3295, 6018, 749, 0.248919906946, 851, 890, 0, 0
petaluma034-2010.png, 1327, 1817, 3144, 304, 0.193384223919, 376, 371, 0, 0
petaluma035-2010.png, 2014, 2452, 4466, 613, 0.274518584863, 718, 715, 0, 0
petaluma036-2010.png, 2084, 3052, 5136, 744, 0.289719626168, 847, 873, 0, 0
petaluma037-2010.png, 3121, 3918, 7039, 1506, 0.427901690581, 1653, 1672, 0, 0
petaluma038-2010.png, 2575, 3727, 6302, 1053, 0.334179625516, 1182, 1217, 0, 0
petaluma039-2010.png, 2596, 4783, 7379, 899, 0.243664453178, 1019, 1100, 0, 0
petaluma040-2010.png, 2205, 4441, 6646, 876, 0.263617213361, 970, 1039, 0, 0
petaluma041-2010.png, 1398, 2077, 3475, 293, 0.168633093525, 342, 362, 0, 0
petaluma042-2010.png, 1999, 2600, 4599, 935, 0.406610132638, 1023, 1065, 0, 0
petaluma043-2010.png, 2372, 3390, 5762, 1129, 0.391877820201, 1224, 1290, 0, 0
petaluma044-2010.png, 2290, 3301, 5591, 1103, 0.394562690038, 1199, 1258, 0, 0
petaluma045-2010.png, 2158, 2739, 4897, 1009, 0.412089034103, 1112, 1151, 0, 0
petaluma046-2010.png, 2466, 3759, 6225, 963, 0.309397590361, 1086, 1146, 0, 0
petaluma047-2010.png, 3036, 5139, 8175, 1323, 0.323669724771, 1451, 1523, 0, 0
petaluma048-2010.png, 1855, 3085, 4940, 907, 0.367206477733, 984, 1027, 0, 0
petaluma049-2010.png, 2015, 2932, 4947, 672, 0.271679805943, 779, 808, 0, 0
petaluma050-2010.png, 2286, 3207, 5493, 1066, 0.388130347715, 1164, 1222, 0, 0
petaluma051-2010.png, 2251, 3318, 5569, 1212, 0.435266654696, 1320, 1389, 0, 0
petaluma052-2010.png, 1651, 2417, 4068, 533, 0.262045231072, 644, 660, 0, 0
petaluma053-2010.png, 1296, 1280, 2576, 339, 0.263198757764, 402, 406, 0, 0
petaluma054-2010.png, 2376, 3830, 6206, 1048, 0.337737673219, 1163, 1227, 0, 0
petaluma055-2010.png, 2402, 3747, 6149, 1179, 0.383476988128, 1290, 1320, 0, 0
petaluma056-2010.png, 2087, 3228, 5315, 873, 0.328504233302, 979, 1031, 0, 0
petaluma057-2010.png, 1208, 1699, 2907, 315, 0.216718266254, 387, 400, 0, 0
petaluma058-2010.png, 2369, 3218, 5587, 1001, 0.358331841776, 1144, 1149, 0, 0
petaluma059-2010.png, 1946, 3127, 5073, 1040, 0.410013798541, 1133, 1191, 0, 0
petaluma060-2010.png, 1266, 1591, 2857, 401, 0.280714035702, 467, 495, 0, 0
petaluma061-2010.png, 2113, 2850, 4963, 778, 0.313520048358, 884, 916, 0, 0
petaluma062-2010.png, 2747, 3928, 6675, 1190, 0.356554307116, 1336, 1365, 0, 0
petaluma063-2010.png, 1502, 1906, 3408, 483, 0.283450704225, 544, 575, 0, 0
petaluma064-2010.png, 1987, 2713, 4700, 767, 0.326382978723, 873, 905, 0, 0
sanjose001-2010.png, 3407, 5240, 8647, 1237, 0.286110789869, 1384, 1430, 0, 0
sanjose002-2010.png, 3231, 4504, 7735, 1079, 0.278991596639, 1210, 1255, 0, 0
sanjose003-2010.png, 3121, 4607, 7728, 1070, 0.276915113872, 1196, 1233, 0, 0
sanjose004-2010.png, 2890, 4235, 7125, 1367, 0.383719298246, 1504, 1546, 0, 0
sanjose005-2010.png, 2566, 4936, 7502, 850, 0.226606238336, 956, 991, 0, 0
sanjose006-2010.png, 2199, 4378, 6577, 1164, 0.353960772389, 1252, 1321, 0, 0
sanjose007-2010.png, 2193, 3902, 6095, 1155, 0.378999179655, 1240, 1320, 0, 0
sanjose008-2010.png, 1142, 2425, 3567, 678, 0.380151387721, 744, 782, 0, 0
sanjose009-2010.png, 3383, 5016, 8399, 922, 0.219549946422, 1078, 1101, 0, 0
sanjose010-2010.png, 3320, 4764, 8084, 950, 0.235032162296, 1089, 1114, 0, 0
sanjose011-2010.png, 4052, 4948, 9000, 1061, 0.235777777778, 1222, 1261, 0, 0
sanjose012-2010.png, 2508, 4327, 6835, 964, 0.282077542063, 1071, 1126, 0, 0
sanjose013-2010.png, 2191, 4203, 6394, 686, 0.214576165155, 778, 812, 0, 0
sanjose014-2010.png, 2340, 4267, 6607, 1062, 0.321477221129, 1161, 1227, 0, 0
sanjose015-2010.png, 2302, 3575, 5877, 996, 0.338948443083, 1100, 1139, 0, 0
sanjose016-2010.png, 1797, 3347, 5144, 947, 0.368195956454, 1054, 1100, 0, 0
sanjose017-2010.png, 3419, 4856, 8275, 926, 0.223806646526, 1086, 1125, 0, 0
sanjose018-2010.png, 2229, 3070, 5299, 764, 0.28835629364, 879, 907, 0, 0
sanjose019-2010.png, 3013, 4304, 7317, 1022, 0.279349460161, 1154, 1200, 0, 0
sanjose020-2010.png, 2496, 4409, 6905, 1061, 0.307313540912, 1160, 1234, 0, 0
sanjose021-2010.png, 2557, 4776, 7333, 876, 0.238919950907, 984, 1004, 0, 0
sanjose022-2010.png, 2590, 3963, 6553, 1224, 0.373569357546, 1341, 1383, 0, 0
sanjose023-2010.png, 1507, 2239, 3746, 766, 0.408969567539, 838, 899, 0, 0
sanjose024-2010.png, 1041, 2398, 3439, 486, 0.282640302413, 539, 586, 0, 0
sanjose025-2010.png, 3066, 3670, 6736, 1198, 0.355700712589, 1359, 1344, 0, 0
sanjose026-2010.png, 3515, 4266, 7781, 1340, 0.344428736666, 1477, 1530, 0, 0
sanjose027-2010.png, 2814, 4099, 6913, 1207, 0.349197164762, 1345, 1438, 0, 0
sanjose028-2010.png, 2762, 4709, 7471, 1423, 0.380939633249, 1546, 1611, 0, 0
sanjose029-2010.png, 2847, 5096, 7943, 1138, 0.286541608964, 1248, 1299, 0, 0
sanjose030-2010.png, 1868, 2826, 4694, 760, 0.32381763954, 845, 874, 0, 0
sanjose031-2010.png, 1819, 2804, 4623, 988, 0.427428077006, 1081, 1113, 0, 0
sanjose032-2010.png, 1496, 3136, 4632, 915, 0.395077720207, 994, 1051, 0, 0
sanjose033-2010.png, 3051, 4587, 7638, 901, 0.235925634983, 1019, 1066, 0, 0
sanjose034-2010.png, 3289, 4443, 7732, 1489, 0.385152612519, 1603, 1670, 0, 0
sanjose035-2010.png, 3047, 4452, 7499, 1399, 0.373116415522, 1532, 1568, 0, 0
sanjose036-2010.png, 2345, 4761, 7106, 1119, 0.314945116803, 1215, 1295, 0, 0
sanjose037-2010.png, 2906, 4913, 7819, 1294, 0.33098861747, 1422, 1469, 0, 0
sanjose038-2010.png, 1178, 1953, 3131, 630, 0.402427339508, 694, 745, 0, 0
sanjose039-2010.png, 1311, 2078, 3389, 637, 0.375922100915, 704, 742, 0, 0
sanjose040-2010.png, 1940, 3373, 5313, 1110, 0.417843026539, 1188, 1272, 0, 0
sanjose041-2010.png, 3277, 4152, 7429, 949, 0.255485260466, 1079, 1120, 0, 0
sanjose042-2010.png, 2338, 3927, 6265, 942, 0.300718276137, 1038, 1064, 0, 0
sanjose043-2010.png, 2894, 4252, 7146, 1573, 0.440246291632, 1687, 1755, 0, 0
sanjose044-2010.png, 2646, 4390, 7036, 1082, 0.307561114269, 1198, 1217, 0, 0
sanjose045-2010.png, 1210, 2106, 3316, 206, 0.124246079614, 262, 290, 0, 0
sanjose046-2010.png, 861, 1617, 2478, 421, 0.339790153349, 479, 511, 0, 0
sanjose047-2010.png, 1751, 3009, 4760, 1055, 0.443277310924, 1130, 1185, 0, 0
sanjose048-2010.png, 2016, 3930, 5946, 1229, 0.413387151026, 1328, 1398, 0, 0
sanjose049-2010.png, 1913, 2850, 4763, 282, 0.118412765064, 364, 373, 0, 0
sanjose050-2010.png, 2138, 3699, 5837, 560, 0.191879390098, 656, 711, 0, 0
sanjose051-2010.png, 2874, 4300, 7174, 1218, 0.339559520491, 1342, 1410, 0, 0
sanjose052-2010.png, 1242, 1880, 3122, 419, 0.268417680974, 490, 491, 0, 0
sanjose053-2010.png, 1107, 1943, 3050, 379, 0.248524590164, 441, 465, 0, 0
sanjose054-2010.png, 1556, 2193, 3749, 862, 0.45985596159, 939, 984, 0, 0
sanjose055-2010.png, 1665, 2624, 4289, 902, 0.420610865003, 974, 1026, 0, 0
sanjose056-2010.png, 1340, 2515, 3855, 841, 0.436316472114, 897, 944, 0, 0
sanjose057-2010.png, 1077, 1910, 2987, 185, 0.123870103783, 232, 266, 0, 0
sanjose058-2010.png, 2181, 3799, 5980, 877, 0.293311036789, 976, 1024, 0, 0
sanjose059-2010.png, 2078, 3289, 5367, 737, 0.274641326626, 825, 869, 0, 0
sanjose060-2010.png, 1888, 2473, 4361, 348, 0.159596422839, 438, 442, 0, 0
sanjose061-2010.png, 991, 2370, 3361, 285, 0.169592383219, 341, 372, 0, 0
sanjose062-2010.png, 870, 2228, 3098, 502, 0.324080051646, 553, 602, 0, 0
sanjose063-2010.png, 1629, 2433, 4062, 979, 0.482028557361, 1068, 1105, 0, 0
sanjose064-2010.png, 1636, 3102, 4738, 1060, 0.447446179823, 1141, 1181, 0, 0
sanysidro001-2010.png, 2452, 3438, 5890, 1007, 0.341935483871, 1098, 1148, 0, 0
sanysidro002-2010.png, 3187, 3642, 6829, 1041, 0.304876262996, 1177, 1176, 0, 0
sanysidro003-2010.png, 2748, 3854, 6602, 560, 0.169645561951, 683, 692, 0, 0
sanysidro004-2010.png, 1959, 2468, 4427, 545, 0.246216399368, 631, 653, 0, 0
sanysidro005-2010.png, 1089, 1520, 2609, 177, 0.13568417018, 222, 230, 0, 0
sanysidro006-2010.png, 729, 1590, 2319, 125, 0.1078050884, 152, 172, 0, 0
sanysidro007-2010.png, 768, 1527, 2295, 89, 0.077559912854, 112, 132, 0, 0
sanysidro008-2010.png, 720, 1572, 2292, 312, 0.272251308901, 355, 375, 0, 0
sanysidro009-2010.png, 2206, 2770, 4976, 1035, 0.415996784566, 1150, 1151, 0, 0
sanysidro010-2010.png, 3497, 3792, 7289, 1187, 0.32569625463, 1345, 1361, 0, 0
sanysidro011-2010.png, 3064, 4062, 7126, 896, 0.251473477407, 1029, 1043, 0, 0
sanysidro012-2010.png, 1874, 2142, 4016, 278, 0.138446215139, 362, 363, 0, 0
sanysidro013-2010.png, 664, 792, 1456, 87, 0.119505494505, 117, 112, 0, 0
sanysidro014-2010.png, 690, 2065, 2755, 164, 0.119056261343, 195, 229, 0, 0
sanysidro015-2010.png, 293, 1094, 1387, 26, 0.0374909877433, 33, 35, 0, 0
sanysidro016-2010.png, 343, 1530, 1873, 148, 0.158035237587, 172, 211, 0, 0
sanysidro017-2010.png, 2716, 3196, 5912, 1091, 0.369079837618, 1205, 1231, 0, 0
sanysidro018-2010.png, 4018, 4407, 8425, 1281, 0.30409495549, 1432, 1437, 0, 0
sanysidro019-2010.png, 4051, 4724, 8775, 1190, 0.271225071225, 1397, 1373, 0, 0
sanysidro020-2010.png, 3036, 3671, 6707, 680, 0.202773222007, 820, 838, 0, 0
sanysidro021-2010.png, 2254, 2910, 5164, 341, 0.132068164214, 448, 417, 0, 0
sanysidro022-2010.png, 1031, 2350, 3381, 219, 0.129547471162, 275, 295, 0, 0
sanysidro023-2010.png, 233, 949, 1182, 25, 0.0423011844332, 36, 51, 0, 0
sanysidro024-2010.png, 209, 920, 1129, 91, 0.161204605846, 109, 115, 0, 0
sanysidro025-2010.png, 3341, 4205, 7546, 1732, 0.459051152929, 1868, 1890, 0, 0
sanysidro026-2010.png, 4013, 4780, 8793, 1364, 0.310246787217, 1528, 1565, 0, 0
sanysidro027-2010.png, 3097, 4125, 7222, 936, 0.25920797563, 1074, 1147, 0, 0
sanysidro028-2010.png, 3600, 4680, 8280, 1355, 0.32729468599, 1492, 1547, 0, 0
sanysidro029-2010.png, 3421, 4472, 7893, 608, 0.15406055999, 781, 773, 0, 0
sanysidro030-2010.png, 2135, 3994, 6129, 256, 0.0835372817752, 334, 367, 0, 0
sanysidro031-2010.png, 252, 840, 1092, 15, 0.0274725274725, 25, 22, 0, 0
sanysidro032-2010.png, 459, 851, 1310, 124, 0.189312977099, 148, 160, 0, 0
sanysidro033-2010.png, 3078, 3964, 7042, 1655, 0.470036921329, 1803, 1815, 0, 0
sanysidro034-2010.png, 3443, 4525, 7968, 1192, 0.299196787149, 1348, 1407, 0, 0
sanysidro035-2010.png, 3969, 4993, 8962, 1107, 0.247043070743, 1265, 1294, 0, 0
sanysidro036-2010.png, 2835, 4203, 7038, 721, 0.204887752202, 813, 865, 0, 0
sanysidro037-2010.png, 3550, 4303, 7853, 684, 0.174200942315, 828, 803, 0, 0
sanysidro038-2010.png, 1976, 3292, 5268, 316, 0.119969627942, 382, 398, 0, 0
sanysidro039-2010.png, 335, 1077, 1412, 6, 0.00849858356941, 9, 8, 0, 0
sanysidro040-2010.png, 279, 602, 881, 11, 0.0249716231555, 15, 17, 0, 0
sanysidro041-2010.png, 3307, 4024, 7331, 1709, 0.466239257946, 1839, 1875, 0, 0
sanysidro042-2010.png, 3550, 4710, 8260, 1155, 0.279661016949, 1301, 1318, 0, 0
sanysidro043-2010.png, 3530, 4946, 8476, 790, 0.186408683341, 941, 957, 0, 0
sanysidro044-2010.png, 2384, 3054, 5438, 404, 0.148584038249, 475, 507, 0, 0
sanysidro045-2010.png, 727, 1167, 1894, 76, 0.0802534318902, 94, 108, 0, 0
sanysidro046-2010.png, 1080, 2105, 3185, 8, 0.00502354788069, 16, 20, 0, 0
sanysidro047-2010.png, 566, 1145, 1711, 75, 0.0876680303916, 97, 101, 0, 0
sanysidro048-2010.png, 670, 1169, 1839, 273, 0.296900489396, 293, 321, 0, 0
sanysidro049-2010.png, 2957, 3976, 6933, 1236, 0.356555603635, 1327, 1376, 0, 0
sanysidro050-2010.png, 3125, 4426, 7551, 884, 0.234141173355, 1003, 1061, 0, 0
sanysidro051-2010.png, 3322, 4754, 8076, 870, 0.215453194651, 988, 1071, 0, 0
sanysidro052-2010.png, 1592, 2903, 4495, 426, 0.189543937709, 511, 533, 0, 0
sanysidro053-2010.png, 204, 1026, 1230, 19, 0.0308943089431, 31, 48, 0, 0
sanysidro054-2010.png, 781, 2032, 2813, 12, 0.00853181656594, 16, 21, 0, 0
sanysidro055-2010.png, 1034, 1592, 2626, 130, 0.0990099009901, 157, 165, 0, 0
sanysidro056-2010.png, 999, 1764, 2763, 392, 0.283749547593, 443, 455, 0, 0
sanysidro057-2010.png, 2983, 4252, 7235, 1653, 0.456945404285, 1776, 1816, 0, 0
sanysidro058-2010.png, 3835, 5155, 8990, 882, 0.196218020022, 1010, 1057, 0, 0
sanysidro059-2010.png, 3760, 5172, 8932, 891, 0.199507389163, 1037, 1070, 0, 0
sanysidro060-2010.png, 2267, 4220, 6487, 504, 0.155387698474, 615, 604, 0, 0
sanysidro061-2010.png, 1917, 3429, 5346, 432, 0.161616161616, 516, 551, 0, 0
sanysidro062-2010.png, 515, 2139, 2654, 77, 0.0580256217031, 90, 111, 0, 0
sanysidro063-2010.png, 1693, 2313, 4006, 304, 0.151772341488, 361, 375, 0, 0
sanysidro064-2010.png, 2491, 3760, 6251, 1115, 0.356742921133, 1235, 1280, 0, 0
yuba001-2010.png, 1983, 3982, 5965, 543, 0.1820620285, 626, 701, 0, 0
yuba002-2010.png, 2531, 4733, 7264, 1378, 0.379405286344, 1495, 1591, 0, 0
yuba003-2010.png, 1461, 2647, 4108, 539, 0.262414800389, 596, 653, 0, 0
yuba004-2010.png, 1974, 3107, 5081, 778, 0.306238929345, 859, 909, 0, 0
yuba005-2010.png, 882, 1337, 2219, 332, 0.299233889139, 401, 442, 0, 0
yuba006-2010.png, 1318, 1847, 3165, 363, 0.229383886256, 437, 453, 0, 0
yuba007-2010.png, 1228, 1265, 2493, 289, 0.231849177698, 377, 395, 0, 0
yuba008-2010.png, 779, 676, 1455, 135, 0.185567010309, 199, 179, 0, 0
yuba009-2010.png, 1916, 4312, 6228, 651, 0.209055876686, 744, 810, 0, 0
yuba010-2010.png, 2560, 4917, 7477, 1299, 0.347465561054, 1417, 1446, 0, 0
yuba011-2010.png, 1883, 3306, 5189, 654, 0.252071690114, 749, 796, 0, 0
yuba012-2010.png, 2525, 4000, 6525, 1205, 0.369348659004, 1301, 1381, 0, 0
yuba013-2010.png, 1596, 2306, 3902, 573, 0.293695540748, 629, 666, 0, 0
yuba014-2010.png, 1001, 1566, 2567, 407, 0.317101675107, 483, 529, 0, 0
yuba015-2010.png, 1001, 1250, 2251, 276, 0.245224344736, 348, 370, 0, 0
yuba016-2010.png, 1024, 499, 1523, 97, 0.127380170716, 126, 115, 0, 0
yuba017-2010.png, 1953, 3626, 5579, 857, 0.307223516759, 960, 1013, 0, 0
yuba018-2010.png, 2732, 5092, 7824, 1414, 0.36145194274, 1543, 1562, 0, 0
yuba019-2010.png, 2714, 4358, 7072, 1283, 0.362839366516, 1384, 1444, 0, 0
yuba020-2010.png, 1286, 2674, 3960, 709, 0.358080808081, 779, 842, 0, 0
yuba021-2010.png, 1353, 2372, 3725, 501, 0.268993288591, 587, 621, 0, 0
yuba022-2010.png, 1064, 1683, 2747, 316, 0.230069166363, 381, 409, 0, 0
yuba023-2010.png, 617, 1042, 1659, 220, 0.265220012055, 271, 291, 0, 0
yuba024-2010.png, 1555, 911, 2466, 178, 0.144363341444, 227, 210, 0, 0
yuba025-2010.png, 1865, 4188, 6053, 673, 0.222369073187, 737, 816, 0, 0
yuba026-2010.png, 1344, 3137, 4481, 624, 0.278509261326, 696, 772, 0, 0
yuba027-2010.png, 2404, 3572, 5976, 889, 0.297523427041, 962, 1034, 0, 0
yuba028-2010.png, 1543, 2759, 4302, 704, 0.327289632729, 787, 825, 0, 0
yuba029-2010.png, 1070, 2269, 3339, 575, 0.344414495358, 639, 699, 0, 0
yuba030-2010.png, 1486, 2351, 3837, 459, 0.239249413604, 542, 584, 0, 0
yuba031-2010.png, 1549, 2114, 3663, 457, 0.249522249522, 551, 590, 0, 0
yuba032-2010.png, 996, 644, 1640, 110, 0.134146341463, 138, 140, 0, 0
yuba033-2010.png, 876, 1563, 2439, 260, 0.213202132021, 320, 340, 0, 0
yuba034-2010.png, 903, 2202, 3105, 355, 0.228663446055, 404, 453, 0, 0
yuba035-2010.png, 1528, 1991, 3519, 770, 0.437624325092, 860, 867, 0, 0
yuba036-2010.png, 750, 1244, 1994, 349, 0.350050150451, 402, 436, 0, 0
yuba037-2010.png, 2111, 3149, 5260, 634, 0.241064638783, 731, 757, 0, 0
yuba038-2010.png, 2265, 3486, 5751, 570, 0.198226395409, 666, 695, 0, 0
yuba039-2010.png, 2090, 3158, 5248, 782, 0.298018292683, 876, 903, 0, 0
yuba040-2010.png, 1783, 2586, 4369, 390, 0.178530556191, 438, 483, 0, 0
yuba041-2010.png, 843, 1669, 2512, 247, 0.196656050955, 300, 339, 0, 0
yuba042-2010.png, 913, 1861, 2774, 406, 0.292718096611, 456, 500, 0, 0
yuba043-2010.png, 1325, 1713, 3038, 466, 0.306780776827, 531, 588, 0, 0
yuba044-2010.png, 693, 703, 1396, 235, 0.336676217765, 282, 274, 0, 0
yuba045-2010.png, 1310, 1703, 3013, 486, 0.32260205775, 565, 586, 0, 0
yuba046-2010.png, 1996, 2588, 4584, 489, 0.21335078534, 560, 596, 0, 0
yuba047-2010.png, 2377, 3582, 5959, 942, 0.316160429602, 1041, 1112, 0, 0
yuba048-2010.png, 2555, 3871, 6426, 729, 0.226890756303, 804, 867, 0, 0
yuba049-2010.png, 1451, 2315, 3766, 520, 0.276155071694, 591, 655, 0, 0
yuba050-2010.png, 1198, 2294, 3492, 477, 0.273195876289, 540, 611, 0, 0
yuba051-2010.png, 1389, 1798, 3187, 441, 0.276749294007, 519, 549, 0, 0
yuba052-2010.png, 959, 1055, 2014, 353, 0.350546176763, 424, 424, 0, 0
yuba053-2010.png, 1351, 1575, 2926, 366, 0.25017088175, 448, 463, 0, 0
yuba054-2010.png, 1214, 1614, 2828, 421, 0.297736916549, 524, 537, 0, 0
yuba055-2010.png, 1248, 1748, 2996, 424, 0.283044058745, 495, 511, 0, 0
yuba056-2010.png, 1319, 2718, 4037, 528, 0.261580381471, 595, 642, 0, 0
yuba057-2010.png, 1448, 2411, 3859, 450, 0.233221041721, 534, 600, 0, 0
yuba058-2010.png, 907, 1718, 2625, 229, 0.174476190476, 274, 293, 0, 0
yuba059-2010.png, 1463, 1922, 3385, 492, 0.290694239291, 598, 609, 0, 0
yuba060-2010.png, 977, 1247, 2224, 287, 0.25809352518, 363, 358, 0, 0
yuba061-2010.png, 1286, 1363, 2649, 490, 0.369950924877, 592, 611, 0, 0
yuba062-2010.png, 1602, 2353, 3955, 545, 0.275600505689, 632, 682, 0, 0
yuba063-2010.png, 1092, 1348, 2440, 381, 0.312295081967, 463, 500, 0, 0
yuba064-2010.png, 1776, 2729, 4505, 697, 0.309433962264, 778, 808, 0, 0
