Filename, N_kps1, N_kps2, Total_kps2, N_matches, average_match_rate, n_forward, n_backward, n_not_first_match_forward, n_not_first_match_backward
jenner001-2010.png, 1231, 1444, 2675, 160, 0.119626168224, 188, 188, 0, 0
jenner002-2010.png, 1183, 1562, 2745, 173, 0.126047358834, 202, 211, 0, 0
jenner003-2010.png, 2099, 2319, 4418, 162, 0.0733363512902, 191, 205, 0, 0
jenner004-2010.png, 1352, 1704, 3056, 140, 0.0916230366492, 159, 167, 0, 0
jenner005-2010.png, 1547, 2345, 3892, 54, 0.0277492291881, 66, 75, 0, 0
jenner006-2010.png, 1627, 2170, 3797, 419, 0.220700553068, 459, 471, 0, 0
jenner007-2010.png, 1446, 2109, 3555, 354, 0.199156118143, 390, 407, 0, 0
jenner008-2010.png, 2279, 3059, 5338, 445, 0.166729112027, 492, 505, 0, 0
jenner009-2010.png, 918, 1332, 2250, 181, 0.160888888889, 194, 206, 0, 0
jenner010-2010.png, 1221, 1803, 3024, 64, 0.042328042328, 76, 75, 0, 0
jenner011-2010.png, 1481, 1335, 2816, 51, 0.0362215909091, 64, 75, 0, 0
jenner012-2010.png, 1867, 2239, 4106, 323, 0.157330735509, 359, 370, 0, 0
jenner013-2010.png, 2173, 2827, 5000, 200, 0.08, 228, 239, 0, 0
jenner014-2010.png, 2013, 2285, 4298, 157, 0.0730572359237, 182, 189, 0, 0
jenner015-2010.png, 1136, 1532, 2668, 168, 0.125937031484, 197, 191, 0, 0
jenner016-2010.png, 1657, 1970, 3627, 227, 0.125172318721, 257, 254, 0, 0
jenner017-2010.png, 1787, 1639, 3426, 238, 0.138937536486, 264, 261, 0, 0
jenner018-2010.png, 1618, 2356, 3974, 206, 0.103673880221, 227, 239, 0, 0
jenner019-2010.png, 2141, 1969, 4110, 36, 0.0175182481752, 60, 48, 0, 0
jenner020-2010.png, 1141, 1477, 2618, 160, 0.122230710466, 190, 189, 0, 0
jenner021-2010.png, 1786, 2648, 4434, 171, 0.0771312584574, 200, 206, 0, 0
jenner022-2010.png, 1876, 1939, 3815, 185, 0.0969855832241, 201, 221, 0, 0
jenner023-2010.png, 1183, 1441, 2624, 223, 0.169969512195, 251, 262, 0, 0
jenner024-2010.png, 1701, 2250, 3951, 359, 0.18172614528, 404, 403, 0, 0
jenner025-2010.png, 2639, 3077, 5716, 735, 0.257172848146, 795, 797, 0, 0
jenner026-2010.png, 1577, 2536, 4113, 128, 0.062241672745, 140, 163, 0, 0
jenner027-2010.png, 2675, 2619, 5294, 214, 0.0808462410276, 249, 252, 0, 0
jenner028-2010.png, 807, 1018, 1825, 61, 0.0668493150685, 73, 74, 0, 0
jenner029-2010.png, 2074, 3076, 5150, 350, 0.135922330097, 389, 416, 0, 0
jenner030-2010.png, 1621, 2334, 3955, 309, 0.156257901391, 353, 359, 0, 0
jenner031-2010.png, 1415, 2181, 3596, 276, 0.153503893215, 312, 319, 0, 0
jenner032-2010.png, 1995, 2388, 4383, 308, 0.140543007073, 355, 370, 0, 0
jenner033-2010.png, 1917, 2353, 4270, 383, 0.179391100703, 434, 433, 0, 0
jenner034-2010.png, 1984, 2752, 4736, 157, 0.0663006756757, 177, 188, 0, 0
jenner035-2010.png, 2584, 2706, 5290, 233, 0.0880907372401, 270, 279, 0, 0
jenner036-2010.png, 1156, 1426, 2582, 185, 0.143299767622, 207, 209, 0, 0
jenner037-2010.png, 1530, 2502, 4032, 224, 0.111111111111, 245, 264, 0, 0
jenner038-2010.png, 1356, 1945, 3301, 205, 0.124204786428, 231, 252, 0, 0
jenner039-2010.png, 696, 1080, 1776, 93, 0.10472972973, 103, 102, 0, 0
jenner040-2010.png, 1409, 1624, 3033, 174, 0.114737883284, 198, 207, 0, 0
jenner041-2010.png, 1714, 2638, 4352, 225, 0.103400735294, 256, 268, 0, 0
jenner042-2010.png, 2330, 3287, 5617, 351, 0.124977746128, 382, 400, 0, 0
jenner043-2010.png, 1837, 2104, 3941, 238, 0.120781527531, 266, 268, 0, 0
jenner044-2010.png, 1252, 1622, 2874, 257, 0.178844815588, 288, 283, 0, 0
jenner045-2010.png, 1716, 2609, 4325, 231, 0.106820809249, 256, 262, 0, 0
jenner046-2010.png, 1451, 2089, 3540, 379, 0.214124293785, 414, 440, 0, 0
jenner047-2010.png, 1014, 1515, 2529, 189, 0.149466192171, 209, 203, 0, 0
jenner048-2010.png, 1846, 2204, 4050, 281, 0.138765432099, 304, 328, 0, 0
jenner049-2010.png, 1557, 2156, 3713, 282, 0.151898734177, 323, 317, 0, 0
jenner050-2010.png, 1402, 2452, 3854, 232, 0.120394395433, 259, 280, 0, 0
jenner051-2010.png, 1574, 1691, 3265, 160, 0.0980091883614, 178, 181, 0, 0
jenner052-2010.png, 1055, 1464, 2519, 276, 0.219134577213, 295, 303, 0, 0
jenner053-2010.png, 1217, 2040, 3257, 191, 0.11728584587, 207, 221, 0, 0
jenner054-2010.png, 973, 1232, 2205, 151, 0.136961451247, 170, 173, 0, 0
jenner055-2010.png, 873, 1112, 1985, 173, 0.174307304786, 192, 193, 0, 0
jenner056-2010.png, 1274, 1235, 2509, 107, 0.0852929453966, 124, 123, 0, 0
jenner057-2010.png, 1669, 2118, 3787, 387, 0.204383416953, 419, 420, 0, 0
jenner058-2010.png, 1323, 2490, 3813, 298, 0.156307369525, 326, 337, 0, 0
jenner059-2010.png, 1574, 1846, 3420, 246, 0.143859649123, 284, 277, 0, 0
jenner060-2010.png, 802, 1118, 1920, 76, 0.0791666666667, 84, 93, 0, 0
jenner061-2010.png, 825, 1575, 2400, 63, 0.0525, 75, 79, 0, 0
jenner062-2010.png, 694, 852, 1546, 105, 0.135834411384, 112, 111, 0, 0
jenner063-2010.png, 1019, 1445, 2464, 203, 0.164772727273, 216, 226, 0, 0
jenner064-2010.png, 1339, 1389, 2728, 147, 0.107771260997, 169, 163, 0, 0
losangeles001-2010.png, 2652, 3887, 6539, 189, 0.0578070041291, 246, 272, 0, 0
losangeles002-2010.png, 3483, 5272, 8755, 436, 0.0996002284409, 499, 526, 0, 0
losangeles003-2010.png, 1543, 4002, 5545, 382, 0.137781785392, 427, 448, 0, 0
losangeles004-2010.png, 859, 3242, 4101, 144, 0.0702267739576, 156, 177, 0, 0
losangeles005-2010.png, 1553, 3940, 5493, 408, 0.148552703441, 439, 477, 0, 0
losangeles006-2010.png, 2221, 4441, 6662, 503, 0.151005703993, 538, 573, 0, 0
losangeles007-2010.png, 2574, 4033, 6607, 812, 0.245799909187, 880, 899, 0, 0
losangeles008-2010.png, 2523, 4400, 6923, 775, 0.223891376571, 824, 858, 0, 0
losangeles009-2010.png, 2991, 4928, 7919, 180, 0.0454602853896, 235, 262, 0, 0
losangeles010-2010.png, 3131, 4900, 8031, 582, 0.14493836384, 619, 651, 0, 0
losangeles011-2010.png, 2256, 4714, 6970, 692, 0.19856527977, 739, 789, 0, 0
losangeles012-2010.png, 1949, 3447, 5396, 504, 0.186805040771, 552, 577, 0, 0
losangeles013-2010.png, 2156, 4206, 6362, 597, 0.187676831185, 655, 681, 0, 0
losangeles014-2010.png, 3267, 4918, 8185, 897, 0.219181429444, 972, 987, 0, 0
losangeles015-2010.png, 1268, 3012, 4280, 392, 0.183177570093, 429, 461, 0, 0
losangeles016-2010.png, 2223, 4318, 6541, 631, 0.192936859807, 663, 693, 0, 0
losangeles017-2010.png, 3041, 4339, 7380, 232, 0.0628726287263, 272, 306, 0, 0
losangeles018-2010.png, 3006, 3988, 6994, 668, 0.191020875036, 761, 753, 0, 0
losangeles019-2010.png, 1602, 3494, 5096, 442, 0.173469387755, 487, 517, 0, 0
losangeles020-2010.png, 2064, 3761, 5825, 569, 0.195364806867, 615, 667, 0, 0
losangeles021-2010.png, 2047, 3487, 5534, 491, 0.177448500181, 543, 587, 0, 0
losangeles022-2010.png, 2921, 4660, 7581, 760, 0.200501253133, 820, 848, 0, 0
losangeles023-2010.png, 2287, 4216, 6503, 693, 0.213132400431, 732, 775, 0, 0
losangeles024-2010.png, 3000, 4667, 7667, 851, 0.221990348246, 891, 923, 0, 0
losangeles025-2010.png, 2780, 4262, 7042, 163, 0.046293666572, 198, 255, 0, 0
losangeles026-2010.png, 3032, 4477, 7509, 539, 0.143561060061, 608, 633, 0, 0
losangeles027-2010.png, 1900, 3756, 5656, 567, 0.200495049505, 630, 639, 0, 0
losangeles028-2010.png, 1906, 3437, 5343, 583, 0.218229459105, 619, 644, 0, 0
losangeles029-2010.png, 2505, 3428, 5933, 694, 0.233945727288, 760, 795, 0, 0
losangeles030-2010.png, 2826, 4570, 7396, 700, 0.189291508924, 759, 796, 0, 0
losangeles031-2010.png, 2801, 4265, 7066, 838, 0.237192187942, 909, 933, 0, 0
losangeles032-2010.png, 2842, 4524, 7366, 785, 0.213141460766, 852, 872, 0, 0
losangeles033-2010.png, 3208, 4557, 7765, 229, 0.0589826142949, 284, 320, 0, 0
losangeles034-2010.png, 3517, 4684, 8201, 282, 0.0687721009633, 331, 356, 0, 0
losangeles035-2010.png, 1880, 4075, 5955, 528, 0.177329974811, 579, 605, 0, 0
losangeles036-2010.png, 2171, 4057, 6228, 572, 0.18368657675, 626, 637, 0, 0
losangeles037-2010.png, 2257, 4127, 6384, 577, 0.180764411028, 640, 670, 0, 0
losangeles038-2010.png, 2689, 4340, 7029, 703, 0.20002845355, 770, 801, 0, 0
losangeles039-2010.png, 2771, 4325, 7096, 860, 0.242390078918, 929, 950, 0, 0
losangeles040-2010.png, 2889, 4516, 7405, 831, 0.224442943957, 895, 934, 0, 0
losangeles041-2010.png, 3702, 4877, 8579, 200, 0.0466254808253, 255, 274, 0, 0
losangeles042-2010.png, 3358, 4090, 7448, 516, 0.138560687433, 574, 598, 0, 0
losangeles043-2010.png, 1671, 3389, 5060, 387, 0.152964426877, 420, 468, 0, 0
losangeles044-2010.png, 2012, 3852, 5864, 442, 0.150750341064, 467, 498, 0, 0
losangeles045-2010.png, 2529, 4177, 6706, 502, 0.149716671637, 547, 569, 0, 0
losangeles046-2010.png, 2665, 4088, 6753, 620, 0.183622093884, 702, 719, 0, 0
losangeles047-2010.png, 2694, 4113, 6807, 873, 0.256500661084, 935, 944, 0, 0
losangeles048-2010.png, 2586, 4387, 6973, 724, 0.207658109852, 769, 804, 0, 0
losangeles049-2010.png, 3307, 4363, 7670, 170, 0.0443285528031, 240, 236, 0, 0
losangeles050-2010.png, 3247, 4106, 7353, 632, 0.171902624779, 709, 729, 0, 0
losangeles051-2010.png, 2414, 4105, 6519, 498, 0.152784169351, 559, 592, 0, 0
losangeles052-2010.png, 2612, 4296, 6908, 563, 0.162999420961, 643, 641, 0, 0
losangeles053-2010.png, 2787, 4052, 6839, 641, 0.187454306185, 716, 742, 0, 0
losangeles054-2010.png, 3211, 4604, 7815, 818, 0.209341010877, 893, 901, 0, 0
losangeles055-2010.png, 2787, 4238, 7025, 942, 0.268185053381, 986, 1002, 0, 0
losangeles056-2010.png, 2536, 3893, 6429, 674, 0.209674910562, 729, 742, 0, 0
losangeles057-2010.png, 3192, 4368, 7560, 202, 0.0534391534392, 252, 269, 0, 0
losangeles058-2010.png, 3250, 4647, 7897, 493, 0.124857540838, 531, 566, 0, 0
losangeles059-2010.png, 2553, 4739, 7292, 460, 0.126165660998, 502, 524, 0, 0
losangeles060-2010.png, 3223, 4841, 8064, 820, 0.203373015873, 864, 907, 0, 0
losangeles061-2010.png, 2890, 4220, 7110, 707, 0.198874824191, 773, 773, 0, 0
losangeles062-2010.png, 3131, 4542, 7673, 747, 0.194708718884, 809, 828, 0, 0
losangeles063-2010.png, 2506, 4205, 6711, 763, 0.22738787066, 823, 834, 0, 0
losangeles064-2010.png, 2963, 4401, 7364, 738, 0.200434546442, 816, 814, 0, 0
merced001-2010.png, 3614, 4717, 8331, 438, 0.105149441844, 489, 514, 0, 0
merced002-2010.png, 3585, 4355, 7940, 153, 0.0385390428212, 193, 208, 0, 0
merced003-2010.png, 866, 1387, 2253, 115, 0.102086107412, 142, 150, 0, 0
merced004-2010.png, 1039, 1357, 2396, 178, 0.14858096828, 218, 232, 0, 0
merced005-2010.png, 597, 734, 1331, 108, 0.162283996995, 126, 133, 0, 0
merced006-2010.png, 360, 637, 997, 31, 0.062186559679, 45, 52, 0, 0
merced007-2010.png, 291, 504, 795, 15, 0.0377358490566, 34, 32, 0, 0
merced008-2010.png, 239, 227, 466, 23, 0.0987124463519, 31, 30, 0, 0
merced009-2010.png, 2814, 4533, 7347, 328, 0.089288144821, 364, 404, 0, 0
merced010-2010.png, 2709, 4229, 6938, 190, 0.0547708273278, 233, 241, 0, 0
merced011-2010.png, 675, 964, 1639, 42, 0.0512507626602, 58, 61, 0, 0
merced012-2010.png, 881, 1129, 2010, 126, 0.125373134328, 160, 170, 0, 0
merced013-2010.png, 603, 621, 1224, 43, 0.0702614379085, 61, 64, 0, 0
merced014-2010.png, 823, 1493, 2316, 82, 0.0708117443869, 106, 117, 0, 0
merced015-2010.png, 419, 1038, 1457, 78, 0.107069320522, 98, 101, 0, 0
merced016-2010.png, 550, 767, 1317, 104, 0.157934700076, 126, 138, 0, 0
merced017-2010.png, 1047, 2001, 3048, 106, 0.0695538057743, 123, 158, 0, 0
merced018-2010.png, 1128, 1834, 2962, 70, 0.0472653612424, 90, 110, 0, 0
merced019-2010.png, 551, 690, 1241, 11, 0.0177276390008, 20, 25, 0, 0
merced020-2010.png, 432, 405, 837, 46, 0.109916367981, 64, 59, 0, 0
merced021-2010.png, 758, 274, 1032, 12, 0.0232558139535, 23, 18, 0, 0
merced022-2010.png, 796, 359, 1155, 39, 0.0675324675325, 49, 45, 0, 0
merced023-2010.png, 452, 578, 1030, 43, 0.0834951456311, 54, 72, 0, 0
merced024-2010.png, 149, 500, 649, 15, 0.0462249614792, 20, 32, 0, 0
merced025-2010.png, 611, 1318, 1929, 49, 0.0508035251426, 66, 98, 0, 0
merced026-2010.png, 1003, 1194, 2197, 88, 0.0801092398726, 118, 118, 0, 0
merced027-2010.png, 1030, 1011, 2041, 51, 0.0499755022048, 76, 74, 0, 0
merced028-2010.png, 640, 252, 892, 16, 0.0358744394619, 26, 27, 0, 0
merced029-2010.png, 1684, 112, 1796, 11, 0.0122494432071, 20, 12, 0, 0
merced030-2010.png, 1582, 98, 1680, 4, 0.0047619047619, 12, 4, 0, 0
merced031-2010.png, 481, 670, 1151, 54, 0.0938314509123, 65, 71, 0, 0
merced032-2010.png, 269, 356, 625, 10, 0.032, 12, 14, 0, 0
merced033-2010.png, 1256, 1512, 2768, 250, 0.18063583815, 284, 291, 0, 0
merced034-2010.png, 935, 1218, 2153, 56, 0.0520204366001, 77, 84, 0, 0
merced035-2010.png, 626, 375, 1001, 30, 0.0599400599401, 47, 38, 0, 0
merced036-2010.png, 1367, 490, 1857, 91, 0.0980075390415, 125, 104, 0, 0
merced037-2010.png, 2973, 968, 3941, 177, 0.0898249175336, 223, 195, 0, 0
merced038-2010.png, 1850, 186, 2036, 20, 0.0196463654224, 29, 20, 0, 0
merced039-2010.png, 784, 472, 1256, 56, 0.0891719745223, 74, 64, 0, 0
merced040-2010.png, 438, 352, 790, 20, 0.0506329113924, 27, 25, 0, 0
merced041-2010.png, 1033, 1113, 2146, 184, 0.171481826654, 239, 230, 0, 0
merced042-2010.png, 1031, 599, 1630, 32, 0.039263803681, 54, 50, 0, 0
merced043-2010.png, 1092, 158, 1250, 22, 0.0352, 32, 25, 0, 0
merced044-2010.png, 1433, 291, 1724, 25, 0.0290023201856, 43, 29, 0, 0
merced045-2010.png, 3179, 746, 3925, 152, 0.0774522292994, 192, 163, 0, 0
merced046-2010.png, 2300, 284, 2584, 42, 0.0325077399381, 66, 45, 0, 0
merced047-2010.png, 916, 754, 1670, 140, 0.167664670659, 161, 160, 0, 0
merced048-2010.png, 916, 1210, 2126, 85, 0.0799623706491, 104, 115, 0, 0
merced049-2010.png, 351, 627, 978, 58, 0.118609406953, 75, 78, 0, 0
merced050-2010.png, 563, 248, 811, 41, 0.10110974106, 59, 60, 0, 0
merced051-2010.png, 1085, 213, 1298, 20, 0.0308166409861, 31, 23, 0, 0
merced052-2010.png, 2085, 186, 2271, 18, 0.0158520475561, 34, 23, 0, 0
merced053-2010.png, 2232, 193, 2425, 22, 0.0181443298969, 43, 22, 0, 0
merced054-2010.png, 1796, 115, 1911, 7, 0.00732600732601, 16, 10, 0, 0
merced055-2010.png, 488, 329, 817, 40, 0.0979192166463, 47, 43, 0, 0
merced056-2010.png, 502, 681, 1183, 33, 0.0557903634827, 41, 47, 0, 0
merced057-2010.png, 477, 226, 703, 12, 0.0341394025605, 19, 14, 0, 0
merced058-2010.png, 440, 32, 472, 11, 0.0466101694915, 21, 13, 0, 0
merced059-2010.png, 655, 203, 858, 23, 0.0536130536131, 33, 31, 0, 0
merced060-2010.png, 1006, 157, 1163, 14, 0.0240756663801, 24, 17, 0, 0
merced061-2010.png, 898, 436, 1334, 23, 0.0344827586207, 39, 28, 0, 0
merced062-2010.png, 1459, 270, 1729, 28, 0.0323886639676, 37, 31, 0, 0
merced063-2010.png, 1310, 317, 1627, 27, 0.0331899200983, 48, 35, 0, 0
merced064-2010.png, 964, 643, 1607, 44, 0.0547604231487, 76, 62, 0, 0
oakland001-2010.png, 2989, 3138, 6127, 204, 0.0665905010609, 248, 251, 0, 0
oakland002-2010.png, 3766, 3458, 7224, 276, 0.0764119601329, 336, 334, 0, 0
oakland003-2010.png, 3959, 4543, 8502, 480, 0.112914608327, 582, 564, 0, 0
oakland004-2010.png, 3764, 4701, 8465, 482, 0.113880685174, 559, 576, 0, 0
oakland005-2010.png, 3288, 3700, 6988, 407, 0.116485403549, 456, 460, 0, 0
oakland006-2010.png, 1843, 1707, 3550, 115, 0.0647887323944, 133, 144, 0, 0
oakland007-2010.png, 1333, 2282, 3615, 346, 0.19142461964, 371, 407, 0, 0
oakland008-2010.png, 1334, 2175, 3509, 512, 0.291821031633, 548, 552, 0, 0
oakland009-2010.png, 2242, 2408, 4650, 132, 0.0567741935484, 183, 172, 0, 0
oakland010-2010.png, 3436, 4128, 7564, 398, 0.105235325225, 448, 478, 0, 0
oakland011-2010.png, 3339, 4512, 7851, 213, 0.0542606037447, 252, 278, 0, 0
oakland012-2010.png, 3637, 4623, 8260, 250, 0.0605326876513, 292, 322, 0, 0
oakland013-2010.png, 2815, 2466, 5281, 49, 0.01855709146, 59, 70, 0, 0
oakland014-2010.png, 1872, 2003, 3875, 149, 0.0769032258065, 180, 188, 0, 0
oakland015-2010.png, 2309, 3482, 5791, 495, 0.170954930064, 544, 557, 0, 0
oakland016-2010.png, 1308, 2239, 3547, 374, 0.210882435861, 405, 417, 0, 0
oakland017-2010.png, 2584, 2835, 5419, 191, 0.0704927108323, 234, 233, 0, 0
oakland018-2010.png, 3244, 4412, 7656, 409, 0.10684430512, 472, 483, 0, 0
oakland019-2010.png, 3565, 4477, 8042, 363, 0.0902760507336, 433, 439, 0, 0
oakland020-2010.png, 3304, 4192, 7496, 145, 0.0386872998933, 176, 196, 0, 0
oakland021-2010.png, 2134, 2743, 4877, 195, 0.0799671929465, 220, 269, 0, 0
oakland022-2010.png, 3899, 4671, 8570, 531, 0.123920653442, 609, 649, 0, 0
oakland023-2010.png, 3172, 4414, 7586, 759, 0.200105457422, 814, 853, 0, 0
oakland024-2010.png, 1401, 2412, 3813, 361, 0.189352216103, 404, 416, 0, 0
oakland025-2010.png, 3430, 3866, 7296, 238, 0.0652412280702, 288, 294, 0, 0
oakland026-2010.png, 4027, 4627, 8654, 528, 0.122024497342, 587, 598, 0, 0
oakland027-2010.png, 2772, 3386, 6158, 186, 0.060409223774, 219, 239, 0, 0
oakland028-2010.png, 2167, 2671, 4838, 174, 0.071930549814, 200, 223, 0, 0
oakland029-2010.png, 3239, 4225, 7464, 349, 0.0935155412647, 402, 428, 0, 0
oakland030-2010.png, 3254, 4182, 7436, 523, 0.140667025282, 603, 631, 0, 0
oakland031-2010.png, 1321, 2602, 3923, 332, 0.169258220749, 359, 387, 0, 0
oakland032-2010.png, 3537, 4940, 8477, 981, 0.231449805356, 1053, 1089, 0, 0
oakland033-2010.png, 3634, 4319, 7953, 243, 0.0611090154659, 280, 302, 0, 0
oakland034-2010.png, 3519, 5195, 8714, 363, 0.0833142070232, 403, 437, 0, 0
oakland035-2010.png, 3092, 3315, 6407, 271, 0.0845949742469, 317, 335, 0, 0
oakland036-2010.png, 2712, 3483, 6195, 214, 0.0690879741727, 248, 266, 0, 0
oakland037-2010.png, 3748, 4846, 8594, 579, 0.13474517105, 669, 687, 0, 0
oakland038-2010.png, 2501, 3545, 6046, 526, 0.173999338406, 590, 613, 0, 0
oakland039-2010.png, 3403, 4958, 8361, 993, 0.237531395766, 1043, 1097, 0, 0
oakland040-2010.png, 3821, 5340, 9161, 1176, 0.25674053051, 1248, 1261, 0, 0
oakland041-2010.png, 3164, 4331, 7495, 253, 0.0675116744496, 294, 318, 0, 0
oakland042-2010.png, 2940, 3654, 6594, 204, 0.0618744313012, 240, 253, 0, 0
oakland043-2010.png, 2594, 2647, 5241, 363, 0.138523182599, 424, 421, 0, 0
oakland044-2010.png, 2818, 3468, 6286, 405, 0.128857779192, 480, 486, 0, 0
oakland045-2010.png, 3709, 4921, 8630, 437, 0.101274623407, 503, 511, 0, 0
oakland046-2010.png, 3168, 4192, 7360, 457, 0.124184782609, 514, 545, 0, 0
oakland047-2010.png, 2838, 4199, 7037, 775, 0.220264317181, 825, 864, 0, 0
oakland048-2010.png, 3205, 4888, 8093, 941, 0.232546645249, 984, 1049, 0, 0
oakland049-2010.png, 3579, 3883, 7462, 212, 0.0568212275529, 259, 264, 0, 0
oakland050-2010.png, 1630, 2204, 3834, 93, 0.0485133020344, 109, 135, 0, 0
oakland051-2010.png, 1742, 2075, 3817, 161, 0.08435944459, 202, 212, 0, 0
oakland052-2010.png, 1326, 1844, 3170, 141, 0.0889589905363, 159, 180, 0, 0
oakland053-2010.png, 2159, 2586, 4745, 272, 0.114646996839, 324, 337, 0, 0
oakland054-2010.png, 1849, 2493, 4342, 281, 0.129433440811, 316, 337, 0, 0
oakland055-2010.png, 3001, 4104, 7105, 869, 0.244616467277, 914, 958, 0, 0
oakland056-2010.png, 3496, 5191, 8687, 1061, 0.244273051686, 1130, 1148, 0, 0
oakland057-2010.png, 1404, 1753, 3157, 65, 0.0411783338613, 77, 83, 0, 0
oakland058-2010.png, 2431, 2386, 4817, 165, 0.0685073697322, 205, 204, 0, 0
oakland059-2010.png, 2031, 2070, 4101, 173, 0.0843696659351, 205, 224, 0, 0
oakland060-2010.png, 2257, 2556, 4813, 216, 0.0897569083732, 250, 256, 0, 0
oakland061-2010.png, 2099, 3130, 5229, 293, 0.112067316887, 337, 370, 0, 0
oakland062-2010.png, 1334, 2235, 3569, 243, 0.136172597366, 273, 296, 0, 0
oakland063-2010.png, 2221, 3204, 5425, 639, 0.235576036866, 688, 715, 0, 0
oakland064-2010.png, 4014, 5421, 9435, 1076, 0.22808691044, 1164, 1165, 0, 0
petaluma001-2010.png, 1518, 2032, 3550, 444, 0.25014084507, 482, 505, 0, 0
petaluma002-2010.png, 3415, 4385, 7800, 999, 0.256153846154, 1058, 1092, 0, 0
petaluma003-2010.png, 1406, 2487, 3893, 261, 0.134086822502, 297, 333, 0, 0
petaluma004-2010.png, 1390, 1657, 3047, 110, 0.072202166065, 151, 164, 0, 0
petaluma005-2010.png, 1123, 1444, 2567, 69, 0.0537592520452, 86, 105, 0, 0
petaluma006-2010.png, 718, 947, 1665, 58, 0.0696696696697, 68, 81, 0, 0
petaluma007-2010.png, 1610, 2162, 3772, 224, 0.118769883351, 253, 275, 0, 0
petaluma008-2010.png, 1232, 2043, 3275, 108, 0.0659541984733, 138, 145, 0, 0
petaluma009-2010.png, 3565, 4461, 8026, 1023, 0.254921505108, 1082, 1094, 0, 0
petaluma010-2010.png, 2965, 3831, 6796, 848, 0.249558563861, 904, 913, 0, 0
petaluma011-2010.png, 2666, 3794, 6460, 599, 0.185448916409, 655, 674, 0, 0
petaluma012-2010.png, 779, 1512, 2291, 45, 0.0392841553907, 58, 71, 0, 0
petaluma013-2010.png, 798, 1501, 2299, 20, 0.0173988690735, 25, 39, 0, 0
petaluma014-2010.png, 1345, 1961, 3306, 189, 0.114337568058, 223, 239, 0, 0
petaluma015-2010.png, 952, 1561, 2513, 173, 0.137684042977, 196, 205, 0, 0
petaluma016-2010.png, 1339, 1820, 3159, 161, 0.10193099082, 194, 207, 0, 0
petaluma017-2010.png, 3437, 4567, 8004, 737, 0.184157921039, 805, 844, 0, 0
petaluma018-2010.png, 3397, 4381, 7778, 672, 0.172795062998, 737, 767, 0, 0
petaluma019-2010.png, 2056, 3195, 5251, 372, 0.141687297658, 414, 451, 0, 0
petaluma020-2010.png, 1478, 1982, 3460, 140, 0.0809248554913, 174, 177, 0, 0
petaluma021-2010.png, 1517, 1790, 3307, 245, 0.148170547324, 267, 283, 0, 0
petaluma022-2010.png, 2163, 2846, 5009, 555, 0.221601117988, 609, 624, 0, 0
petaluma023-2010.png, 1679, 2263, 3942, 199, 0.100963977676, 233, 254, 0, 0
petaluma024-2010.png, 1921, 2616, 4537, 245, 0.10800088164, 292, 302, 0, 0
petaluma025-2010.png, 2577, 3550, 6127, 561, 0.183123877917, 621, 648, 0, 0
petaluma026-2010.png, 1689, 2616, 4305, 262, 0.121718931475, 304, 321, 0, 0
petaluma027-2010.png, 1227, 1649, 2876, 177, 0.123087621697, 205, 225, 0, 0
petaluma028-2010.png, 1489, 2067, 3556, 150, 0.0843644544432, 179, 205, 0, 0
petaluma029-2010.png, 1835, 2455, 4290, 398, 0.185547785548, 450, 469, 0, 0
petaluma030-2010.png, 1688, 2296, 3984, 386, 0.193775100402, 417, 438, 0, 0
petaluma031-2010.png, 1246, 1883, 3129, 104, 0.0664749121125, 132, 151, 0, 0
petaluma032-2010.png, 2711, 3610, 6321, 208, 0.0658123714602, 251, 263, 0, 0
petaluma033-2010.png, 2593, 3051, 5644, 386, 0.136782423813, 444, 467, 0, 0
petaluma034-2010.png, 1164, 1613, 2777, 153, 0.110190853439, 171, 191, 0, 0
petaluma035-2010.png, 1790, 2128, 3918, 217, 0.110770801429, 259, 262, 0, 0
petaluma036-2010.png, 1683, 2593, 4276, 188, 0.087932647334, 217, 249, 0, 0
petaluma037-2010.png, 2840, 3505, 6345, 629, 0.198266351458, 684, 724, 0, 0
petaluma038-2010.png, 2642, 3573, 6215, 624, 0.200804505229, 689, 700, 0, 0
petaluma039-2010.png, 3455, 4503, 7958, 321, 0.0806735360643, 375, 406, 0, 0
petaluma040-2010.png, 3066, 4054, 7120, 296, 0.0831460674157, 348, 376, 0, 0
petaluma041-2010.png, 1303, 1948, 3251, 205, 0.126115041526, 226, 232, 0, 0
petaluma042-2010.png, 1729, 2453, 4182, 404, 0.193208990913, 435, 461, 0, 0
petaluma043-2010.png, 1986, 2923, 4909, 416, 0.169484620086, 461, 495, 0, 0
petaluma044-2010.png, 2176, 3125, 5301, 362, 0.13657800415, 400, 450, 0, 0
petaluma045-2010.png, 2082, 2531, 4613, 356, 0.154346412313, 393, 416, 0, 0
petaluma046-2010.png, 2552, 3426, 5978, 453, 0.151555704249, 513, 523, 0, 0
petaluma047-2010.png, 3885, 5064, 8949, 526, 0.117555034082, 593, 617, 0, 0
petaluma048-2010.png, 1811, 2659, 4470, 378, 0.169127516779, 420, 444, 0, 0
petaluma049-2010.png, 2021, 2825, 4846, 357, 0.14733801073, 400, 423, 0, 0
petaluma050-2010.png, 2065, 2953, 5018, 405, 0.161418891989, 452, 480, 0, 0
petaluma051-2010.png, 2080, 2924, 5004, 482, 0.192645883293, 535, 543, 0, 0
petaluma052-2010.png, 1628, 2206, 3834, 174, 0.0907668231612, 202, 224, 0, 0
petaluma053-2010.png, 1571, 1428, 2999, 89, 0.0593531177059, 115, 116, 0, 0
petaluma054-2010.png, 2505, 3392, 5897, 380, 0.128879091063, 433, 452, 0, 0
petaluma055-2010.png, 2539, 3373, 5912, 580, 0.196211096076, 643, 665, 0, 0
petaluma056-2010.png, 2041, 2862, 4903, 364, 0.148480522129, 409, 443, 0, 0
petaluma057-2010.png, 952, 1376, 2328, 146, 0.125429553265, 167, 186, 0, 0
petaluma058-2010.png, 2040, 2887, 4927, 387, 0.157093566065, 429, 459, 0, 0
petaluma059-2010.png, 1916, 2948, 4864, 404, 0.166118421053, 445, 474, 0, 0
petaluma060-2010.png, 1321, 1484, 2805, 129, 0.0919786096257, 157, 167, 0, 0
petaluma061-2010.png, 2235, 2453, 4688, 238, 0.101535836177, 281, 294, 0, 0
petaluma062-2010.png, 2852, 3838, 6690, 466, 0.139312406577, 538, 568, 0, 0
petaluma063-2010.png, 1573, 1679, 3252, 201, 0.123616236162, 239, 232, 0, 0
petaluma064-2010.png, 1714, 2169, 3883, 347, 0.178727787793, 391, 388, 0, 0
sanjose001-2010.png, 4089, 4742, 8831, 304, 0.0688483750425, 376, 384, 0, 0
sanjose002-2010.png, 3843, 4453, 8296, 288, 0.069431051109, 362, 366, 0, 0
sanjose003-2010.png, 3427, 4393, 7820, 278, 0.0710997442455, 340, 343, 0, 0
sanjose004-2010.png, 2783, 3433, 6216, 492, 0.158301158301, 558, 560, 0, 0
sanjose005-2010.png, 3464, 4760, 8224, 442, 0.107490272374, 494, 512, 0, 0
sanjose006-2010.png, 3075, 4312, 7387, 715, 0.193583322052, 771, 785, 0, 0
sanjose007-2010.png, 2895, 3941, 6836, 706, 0.206553540082, 759, 759, 0, 0
sanjose008-2010.png, 1147, 2234, 3381, 366, 0.216503992902, 385, 417, 0, 0
sanjose009-2010.png, 3784, 4763, 8547, 208, 0.048672048672, 260, 258, 0, 0
sanjose010-2010.png, 3486, 4553, 8039, 213, 0.0529916656301, 256, 282, 0, 0
sanjose011-2010.png, 4003, 4493, 8496, 269, 0.0633239171375, 328, 339, 0, 0
sanjose012-2010.png, 2850, 3896, 6746, 347, 0.102875778239, 412, 429, 0, 0
sanjose013-2010.png, 2897, 3797, 6694, 317, 0.0947116821034, 364, 387, 0, 0
sanjose014-2010.png, 2972, 4039, 7011, 525, 0.149764655541, 586, 615, 0, 0
sanjose015-2010.png, 2593, 3407, 6000, 500, 0.166666666667, 544, 569, 0, 0
sanjose016-2010.png, 1526, 2923, 4449, 379, 0.170375365251, 412, 442, 0, 0
sanjose017-2010.png, 3556, 4285, 7841, 211, 0.0538196658589, 270, 268, 0, 0
sanjose018-2010.png, 2410, 3050, 5460, 264, 0.0967032967033, 316, 334, 0, 0
sanjose019-2010.png, 2999, 4055, 7054, 214, 0.0606747944429, 268, 266, 0, 0
sanjose020-2010.png, 2843, 3908, 6751, 326, 0.0965782846986, 369, 396, 0, 0
sanjose021-2010.png, 3125, 4461, 7586, 387, 0.102030055365, 436, 451, 0, 0
sanjose022-2010.png, 3029, 3823, 6852, 626, 0.182720373614, 698, 693, 0, 0
sanjose023-2010.png, 1215, 1776, 2991, 273, 0.182547642929, 310, 322, 0, 0
sanjose024-2010.png, 1019, 2247, 3266, 190, 0.116350275566, 205, 237, 0, 0
sanjose025-2010.png, 2756, 3204, 5960, 326, 0.109395973154, 385, 387, 0, 0
sanjose026-2010.png, 3509, 3989, 7498, 393, 0.104827954121, 487, 467, 0, 0
sanjose027-2010.png, 3107, 3595, 6702, 373, 0.111310056699, 441, 453, 0, 0
sanjose028-2010.png, 3523, 4455, 7978, 588, 0.147405364753, 672, 695, 0, 0
sanjose029-2010.png, 3476, 4812, 8288, 485, 0.117036679537, 543, 557, 0, 0
sanjose030-2010.png, 2190, 2933, 5123, 473, 0.184657427289, 514, 532, 0, 0
sanjose031-2010.png, 1781, 2446, 4227, 461, 0.218121599243, 496, 512, 0, 0
sanjose032-2010.png, 1512, 3203, 4715, 431, 0.18282078473, 449, 501, 0, 0
sanjose033-2010.png, 3542, 4048, 7590, 229, 0.0603425559947, 295, 293, 0, 0
sanjose034-2010.png, 3586, 3914, 7500, 433, 0.115466666667, 509, 507, 0, 0
sanjose035-2010.png, 3347, 4015, 7362, 441, 0.119804400978, 522, 533, 0, 0
sanjose036-2010.png, 3005, 4109, 7114, 422, 0.118639302783, 491, 491, 0, 0
sanjose037-2010.png, 3244, 4800, 8044, 577, 0.143460964694, 627, 685, 0, 0
sanjose038-2010.png, 1161, 1945, 3106, 395, 0.254346426272, 421, 440, 0, 0
sanjose039-2010.png, 1406, 2189, 3595, 373, 0.207510431154, 398, 418, 0, 0
sanjose040-2010.png, 2178, 3845, 6023, 563, 0.186950024905, 596, 630, 0, 0
sanjose041-2010.png, 3267, 3635, 6902, 264, 0.0764995653434, 326, 342, 0, 0
sanjose042-2010.png, 2688, 3498, 6186, 320, 0.103459424507, 366, 390, 0, 0
sanjose043-2010.png, 3047, 3599, 6646, 528, 0.158892566958, 604, 612, 0, 0
sanjose044-2010.png, 3155, 3948, 7103, 381, 0.10727861467, 443, 448, 0, 0
sanjose045-2010.png, 1081, 1723, 2804, 85, 0.0606276747504, 101, 127, 0, 0
sanjose046-2010.png, 730, 1526, 2256, 222, 0.196808510638, 240, 263, 0, 0
sanjose047-2010.png, 1653, 2715, 4368, 468, 0.214285714286, 499, 519, 0, 0
sanjose048-2010.png, 2316, 4241, 6557, 607, 0.185145645875, 643, 679, 0, 0
sanjose049-2010.png, 1880, 2568, 4448, 125, 0.0562050359712, 163, 180, 0, 0
sanjose050-2010.png, 2725, 3625, 6350, 190, 0.059842519685, 243, 253, 0, 0
sanjose051-2010.png, 3372, 4098, 7470, 418, 0.111914323963, 466, 500, 0, 0
sanjose052-2010.png, 1087, 1533, 2620, 147, 0.112213740458, 171, 185, 0, 0
sanjose053-2010.png, 857, 1452, 2309, 129, 0.111736682547, 158, 168, 0, 0
sanjose054-2010.png, 1426, 2007, 3433, 431, 0.251092339062, 474, 484, 0, 0
sanjose055-2010.png, 1708, 2702, 4410, 464, 0.210430839002, 501, 520, 0, 0
sanjose056-2010.png, 1700, 2766, 4466, 466, 0.20868786386, 508, 516, 0, 0
sanjose057-2010.png, 1056, 1594, 2650, 98, 0.0739622641509, 118, 137, 0, 0
sanjose058-2010.png, 2569, 3857, 6426, 322, 0.100217864924, 377, 402, 0, 0
sanjose059-2010.png, 2177, 3161, 5338, 229, 0.0857999250656, 270, 289, 0, 0
sanjose060-2010.png, 1604, 2243, 3847, 113, 0.0587470756434, 137, 157, 0, 0
sanjose061-2010.png, 633, 1716, 2349, 68, 0.0578969774372, 81, 102, 0, 0
sanjose062-2010.png, 855, 2158, 3013, 317, 0.210421506804, 334, 360, 0, 0
sanjose063-2010.png, 1720, 2594, 4314, 508, 0.235512285582, 548, 547, 0, 0
sanjose064-2010.png, 1608, 3058, 4666, 614, 0.263180454351, 630, 661, 0, 0
sanysidro001-2010.png, 2929, 3887, 6816, 533, 0.156396713615, 608, 617, 0, 0
sanysidro002-2010.png, 3351, 3915, 7266, 545, 0.150013762731, 619, 630, 0, 0
sanysidro003-2010.png, 2731, 3602, 6333, 208, 0.065687667772, 250, 273, 0, 0
sanysidro004-2010.png, 1731, 2318, 4049, 171, 0.0844653000741, 218, 237, 0, 0
sanysidro005-2010.png, 1283, 1560, 2843, 115, 0.0809004572635, 143, 140, 0, 0
sanysidro006-2010.png, 666, 1372, 2038, 54, 0.0529931305201, 71, 80, 0, 0
sanysidro007-2010.png, 598, 1384, 1982, 49, 0.0494450050454, 59, 86, 0, 0
sanysidro008-2010.png, 727, 1467, 2194, 161, 0.14676390155, 180, 193, 0, 0
sanysidro009-2010.png, 2095, 2751, 4846, 472, 0.194799834915, 528, 553, 0, 0
sanysidro010-2010.png, 3881, 4405, 8286, 652, 0.157373883659, 765, 751, 0, 0
sanysidro011-2010.png, 2877, 3867, 6744, 233, 0.0690984578885, 283, 315, 0, 0
sanysidro012-2010.png, 1634, 1958, 3592, 117, 0.065144766147, 158, 158, 0, 0
sanysidro013-2010.png, 558, 698, 1256, 50, 0.0796178343949, 66, 65, 0, 0
sanysidro014-2010.png, 808, 1888, 2696, 101, 0.0749258160237, 113, 142, 0, 0
sanysidro015-2010.png, 180, 834, 1014, 10, 0.0197238658777, 12, 15, 0, 0
sanysidro016-2010.png, 291, 1649, 1940, 78, 0.080412371134, 79, 94, 0, 0
sanysidro017-2010.png, 3045, 3530, 6575, 572, 0.173992395437, 656, 648, 0, 0
sanysidro018-2010.png, 4127, 4821, 8948, 528, 0.118015198927, 612, 613, 0, 0
sanysidro019-2010.png, 3574, 4596, 8170, 316, 0.0773561811506, 389, 384, 0, 0
sanysidro020-2010.png, 2980, 3542, 6522, 185, 0.0567310640908, 221, 250, 0, 0
sanysidro021-2010.png, 2035, 2809, 4844, 144, 0.0594549958712, 179, 193, 0, 0
sanysidro022-2010.png, 1085, 2054, 3139, 120, 0.076457470532, 145, 162, 0, 0
sanysidro023-2010.png, 202, 764, 966, 14, 0.0289855072464, 16, 23, 0, 0
sanysidro024-2010.png, 146, 799, 945, 33, 0.0698412698413, 34, 46, 0, 0
sanysidro025-2010.png, 3607, 4474, 8081, 1051, 0.260116322237, 1137, 1145, 0, 0
sanysidro026-2010.png, 3983, 4920, 8903, 530, 0.119060990677, 599, 645, 0, 0
sanysidro027-2010.png, 2856, 3693, 6549, 260, 0.0794014353336, 309, 336, 0, 0
sanysidro028-2010.png, 3561, 4692, 8253, 475, 0.115109657094, 544, 592, 0, 0
sanysidro029-2010.png, 3078, 4189, 7267, 156, 0.0429338103757, 211, 233, 0, 0
sanysidro030-2010.png, 2414, 3781, 6195, 82, 0.0264729620662, 122, 132, 0, 0
sanysidro031-2010.png, 210, 730, 940, 8, 0.0170212765957, 12, 19, 0, 0
sanysidro032-2010.png, 449, 802, 1251, 58, 0.0927258193445, 76, 77, 0, 0
sanysidro033-2010.png, 3226, 4010, 7236, 877, 0.242399115533, 958, 974, 0, 0
sanysidro034-2010.png, 3811, 4598, 8409, 466, 0.110833630634, 535, 565, 0, 0
sanysidro035-2010.png, 3753, 4836, 8589, 276, 0.0642682500873, 350, 363, 0, 0
sanysidro036-2010.png, 3148, 4433, 7581, 214, 0.0564569318032, 254, 268, 0, 0
sanysidro037-2010.png, 3239, 4212, 7451, 236, 0.0633472017179, 287, 315, 0, 0
sanysidro038-2010.png, 1935, 3071, 5006, 111, 0.0443467838594, 132, 156, 0, 0
sanysidro039-2010.png, 216, 745, 961, 4, 0.00832466181061, 6, 8, 0, 0
sanysidro040-2010.png, 279, 521, 800, 6, 0.015, 10, 9, 0, 0
sanysidro041-2010.png, 3507, 4336, 7843, 992, 0.252964426877, 1070, 1084, 0, 0
sanysidro042-2010.png, 3837, 4804, 8641, 445, 0.102997338271, 514, 528, 0, 0
sanysidro043-2010.png, 3642, 5027, 8669, 221, 0.0509862729265, 286, 293, 0, 0
sanysidro044-2010.png, 2487, 3070, 5557, 135, 0.0485873672845, 171, 190, 0, 0
sanysidro045-2010.png, 596, 1094, 1690, 50, 0.0591715976331, 60, 70, 0, 0
sanysidro046-2010.png, 927, 1838, 2765, 14, 0.0101265822785, 23, 31, 0, 0
sanysidro047-2010.png, 432, 1057, 1489, 43, 0.0577568838146, 51, 60, 0, 0
sanysidro048-2010.png, 640, 1130, 1770, 185, 0.209039548023, 195, 204, 0, 0
sanysidro049-2010.png, 3435, 4428, 7863, 663, 0.168637924456, 740, 732, 0, 0
sanysidro050-2010.png, 3434, 4417, 7851, 400, 0.101897847408, 455, 480, 0, 0
sanysidro051-2010.png, 3232, 4407, 7639, 203, 0.0531483178426, 247, 252, 0, 0
sanysidro052-2010.png, 1819, 2814, 4633, 171, 0.0738182603065, 196, 217, 0, 0
sanysidro053-2010.png, 177, 960, 1137, 12, 0.0211081794195, 18, 27, 0, 0
sanysidro054-2010.png, 635, 1655, 2290, 16, 0.0139737991266, 19, 27, 0, 0
sanysidro055-2010.png, 879, 1435, 2314, 38, 0.0328435609334, 48, 62, 0, 0
sanysidro056-2010.png, 947, 1701, 2648, 230, 0.173716012085, 249, 262, 0, 0
sanysidro057-2010.png, 3255, 4405, 7660, 802, 0.209399477807, 871, 921, 0, 0
sanysidro058-2010.png, 4302, 5361, 9663, 375, 0.0776156473145, 456, 465, 0, 0
sanysidro059-2010.png, 3754, 4984, 8738, 237, 0.0542458228428, 299, 304, 0, 0
sanysidro060-2010.png, 2901, 4120, 7021, 174, 0.0495655889474, 219, 227, 0, 0
sanysidro061-2010.png, 1911, 3185, 5096, 153, 0.0600470957614, 188, 207, 0, 0
sanysidro062-2010.png, 472, 1857, 2329, 31, 0.026620867325, 34, 55, 0, 0
sanysidro063-2010.png, 1423, 2064, 3487, 81, 0.0464582735876, 98, 123, 0, 0
sanysidro064-2010.png, 2693, 3711, 6404, 576, 0.179887570269, 631, 668, 0, 0
yuba001-2010.png, 2187, 3703, 5890, 164, 0.0556876061121, 193, 225, 0, 0
yuba002-2010.png, 2821, 4520, 7341, 632, 0.172183626209, 694, 745, 0, 0
yuba003-2010.png, 1403, 2424, 3827, 260, 0.135876665796, 293, 317, 0, 0
yuba004-2010.png, 2289, 3116, 5405, 406, 0.150231267345, 469, 490, 0, 0
yuba005-2010.png, 432, 505, 937, 90, 0.192102454642, 111, 110, 0, 0
yuba006-2010.png, 1074, 1476, 2550, 129, 0.101176470588, 171, 171, 0, 0
yuba007-2010.png, 847, 949, 1796, 104, 0.115812917595, 140, 145, 0, 0
yuba008-2010.png, 470, 413, 883, 36, 0.0815402038505, 52, 51, 0, 0
yuba009-2010.png, 2386, 4137, 6523, 182, 0.0558025448413, 216, 242, 0, 0
yuba010-2010.png, 3008, 4599, 7607, 783, 0.205863020902, 829, 857, 0, 0
yuba011-2010.png, 2183, 3049, 5232, 388, 0.148318042813, 424, 467, 0, 0
yuba012-2010.png, 3032, 4028, 7060, 590, 0.167138810198, 656, 682, 0, 0
yuba013-2010.png, 1586, 2321, 3907, 274, 0.140261069875, 310, 321, 0, 0
yuba014-2010.png, 665, 869, 1534, 108, 0.140808344198, 144, 144, 0, 0
yuba015-2010.png, 735, 958, 1693, 108, 0.127584170112, 133, 145, 0, 0
yuba016-2010.png, 982, 462, 1444, 36, 0.0498614958449, 52, 48, 0, 0
yuba017-2010.png, 2010, 2982, 4992, 262, 0.104967948718, 303, 336, 0, 0
yuba018-2010.png, 3076, 4574, 7650, 831, 0.217254901961, 897, 928, 0, 0
yuba019-2010.png, 2724, 3919, 6643, 606, 0.182447689297, 677, 687, 0, 0
yuba020-2010.png, 1218, 2099, 3317, 299, 0.180283388604, 342, 365, 0, 0
yuba021-2010.png, 1147, 1853, 3000, 213, 0.142, 246, 270, 0, 0
yuba022-2010.png, 790, 1104, 1894, 121, 0.127771911299, 148, 162, 0, 0
yuba023-2010.png, 501, 938, 1439, 77, 0.10701876303, 94, 110, 0, 0
yuba024-2010.png, 1111, 724, 1835, 69, 0.075204359673, 89, 82, 0, 0
yuba025-2010.png, 2470, 3961, 6431, 225, 0.0699735655419, 257, 290, 0, 0
yuba026-2010.png, 1641, 2936, 4577, 333, 0.145510159493, 369, 406, 0, 0
yuba027-2010.png, 2639, 3371, 6010, 503, 0.167387687188, 565, 575, 0, 0
yuba028-2010.png, 1622, 2541, 4163, 393, 0.188806149411, 432, 456, 0, 0
yuba029-2010.png, 934, 1920, 2854, 203, 0.14225648213, 233, 266, 0, 0
yuba030-2010.png, 1392, 1970, 3362, 153, 0.0910172516359, 202, 226, 0, 0
yuba031-2010.png, 1228, 1660, 2888, 143, 0.0990304709141, 169, 188, 0, 0
yuba032-2010.png, 994, 621, 1615, 48, 0.0594427244582, 66, 64, 0, 0
yuba033-2010.png, 740, 1318, 2058, 106, 0.103012633625, 120, 143, 0, 0
yuba034-2010.png, 818, 1589, 2407, 154, 0.127960116327, 172, 204, 0, 0
yuba035-2010.png, 1338, 1736, 3074, 364, 0.236824983735, 401, 414, 0, 0
yuba036-2010.png, 570, 773, 1343, 116, 0.172747580045, 135, 149, 0, 0
yuba037-2010.png, 1793, 2551, 4344, 263, 0.121086556169, 309, 325, 0, 0
yuba038-2010.png, 2070, 2864, 4934, 227, 0.0920145926226, 274, 298, 0, 0
yuba039-2010.png, 1772, 2644, 4416, 235, 0.10643115942, 282, 306, 0, 0
yuba040-2010.png, 1710, 2155, 3865, 143, 0.0739974126779, 176, 180, 0, 0
yuba041-2010.png, 654, 1225, 1879, 87, 0.0926024481107, 104, 114, 0, 0
yuba042-2010.png, 989, 1972, 2961, 164, 0.110773387369, 192, 210, 0, 0
yuba043-2010.png, 1009, 1204, 2213, 156, 0.140985088116, 185, 209, 0, 0
yuba044-2010.png, 468, 442, 910, 89, 0.195604395604, 111, 115, 0, 0
yuba045-2010.png, 856, 1129, 1985, 173, 0.174307304786, 203, 212, 0, 0
yuba046-2010.png, 1631, 2006, 3637, 160, 0.0879846026945, 187, 212, 0, 0
yuba047-2010.png, 2249, 3190, 5439, 332, 0.122081264938, 413, 426, 0, 0
yuba048-2010.png, 2247, 3038, 5285, 238, 0.0900662251656, 294, 305, 0, 0
yuba049-2010.png, 1290, 1726, 3016, 171, 0.113395225464, 216, 223, 0, 0
yuba050-2010.png, 1064, 1794, 2858, 226, 0.158152554234, 260, 276, 0, 0
yuba051-2010.png, 1111, 1444, 2555, 203, 0.158904109589, 230, 252, 0, 0
yuba052-2010.png, 372, 509, 881, 68, 0.154370034052, 79, 92, 0, 0
yuba053-2010.png, 712, 824, 1536, 84, 0.109375, 106, 118, 0, 0
yuba054-2010.png, 862, 929, 1791, 140, 0.156337241764, 186, 182, 0, 0
yuba055-2010.png, 1124, 1579, 2703, 150, 0.110987791343, 187, 209, 0, 0
yuba056-2010.png, 1999, 2996, 4995, 405, 0.162162162162, 454, 477, 0, 0
yuba057-2010.png, 1408, 1966, 3374, 155, 0.0918790752816, 191, 214, 0, 0
yuba058-2010.png, 850, 1217, 2067, 97, 0.0938558297049, 122, 129, 0, 0
yuba059-2010.png, 1041, 1588, 2629, 191, 0.145302396348, 216, 242, 0, 0
yuba060-2010.png, 661, 894, 1555, 114, 0.146623794212, 142, 147, 0, 0
yuba061-2010.png, 589, 609, 1198, 128, 0.213689482471, 154, 164, 0, 0
yuba062-2010.png, 1504, 2005, 3509, 169, 0.096323738957, 226, 242, 0, 0
yuba063-2010.png, 799, 888, 1687, 138, 0.163604030824, 178, 178, 0, 0
yuba064-2010.png, 2444, 3235, 5679, 491, 0.172917767213, 546, 565, 0, 0
