Filename, N_kps1, N_kps2, Total_kps2, N_matches, average_match_rate, n_forward, n_backward, n_not_first_match_forward, n_not_first_match_backward
jenner001-2010.png, 1231, 1444, 2675, 151, 0.112897196262, 172, 171, 0, 0
jenner002-2010.png, 1183, 1562, 2745, 166, 0.120947176685, 190, 197, 0, 0
jenner003-2010.png, 2099, 2319, 4418, 157, 0.0710728836578, 178, 191, 0, 0
jenner004-2010.png, 1352, 1704, 3056, 134, 0.0876963350785, 151, 157, 0, 0
jenner005-2010.png, 1547, 2345, 3892, 54, 0.0277492291881, 65, 75, 0, 0
jenner006-2010.png, 1627, 2170, 3797, 408, 0.214906505136, 447, 454, 0, 0
jenner007-2010.png, 1446, 2109, 3555, 343, 0.192967651195, 370, 388, 0, 0
jenner008-2010.png, 2279, 3059, 5338, 437, 0.163731734732, 481, 487, 0, 0
jenner009-2010.png, 918, 1332, 2250, 180, 0.16, 193, 199, 0, 0
jenner010-2010.png, 1221, 1803, 3024, 60, 0.0396825396825, 72, 67, 0, 0
jenner011-2010.png, 1481, 1335, 2816, 50, 0.0355113636364, 60, 69, 0, 0
jenner012-2010.png, 1867, 2239, 4106, 312, 0.151972722845, 343, 349, 0, 0
jenner013-2010.png, 2173, 2827, 5000, 191, 0.0764, 214, 224, 0, 0
jenner014-2010.png, 2013, 2285, 4298, 154, 0.071661237785, 176, 182, 0, 0
jenner015-2010.png, 1136, 1532, 2668, 162, 0.12143928036, 188, 182, 0, 0
jenner016-2010.png, 1657, 1970, 3627, 218, 0.120209539564, 239, 236, 0, 0
jenner017-2010.png, 1787, 1639, 3426, 229, 0.13368359603, 251, 247, 0, 0
jenner018-2010.png, 1618, 2356, 3974, 202, 0.101660795169, 221, 234, 0, 0
jenner019-2010.png, 2141, 1969, 4110, 35, 0.0170316301703, 56, 45, 0, 0
jenner020-2010.png, 1141, 1477, 2618, 157, 0.119938884645, 183, 177, 0, 0
jenner021-2010.png, 1786, 2648, 4434, 162, 0.0730717185386, 186, 190, 0, 0
jenner022-2010.png, 1876, 1939, 3815, 179, 0.0938401048493, 195, 208, 0, 0
jenner023-2010.png, 1183, 1441, 2624, 222, 0.169207317073, 243, 254, 0, 0
jenner024-2010.png, 1701, 2250, 3951, 343, 0.173626929891, 382, 380, 0, 0
jenner025-2010.png, 2639, 3077, 5716, 714, 0.249825052484, 768, 766, 0, 0
jenner026-2010.png, 1577, 2536, 4113, 125, 0.06078288354, 137, 158, 0, 0
jenner027-2010.png, 2675, 2619, 5294, 203, 0.0766905931243, 234, 231, 0, 0
jenner028-2010.png, 807, 1018, 1825, 58, 0.0635616438356, 68, 69, 0, 0
jenner029-2010.png, 2074, 3076, 5150, 338, 0.131262135922, 376, 397, 0, 0
jenner030-2010.png, 1621, 2334, 3955, 302, 0.152718078382, 335, 343, 0, 0
jenner031-2010.png, 1415, 2181, 3596, 271, 0.150723025584, 304, 310, 0, 0
jenner032-2010.png, 1995, 2388, 4383, 299, 0.136436230892, 341, 354, 0, 0
jenner033-2010.png, 1917, 2353, 4270, 379, 0.177517564403, 424, 423, 0, 0
jenner034-2010.png, 1984, 2752, 4736, 150, 0.0633445945946, 168, 176, 0, 0
jenner035-2010.png, 2584, 2706, 5290, 222, 0.0839319470699, 253, 259, 0, 0
jenner036-2010.png, 1156, 1426, 2582, 183, 0.141750580945, 205, 203, 0, 0
jenner037-2010.png, 1530, 2502, 4032, 219, 0.108630952381, 239, 256, 0, 0
jenner038-2010.png, 1356, 1945, 3301, 203, 0.122993032414, 226, 243, 0, 0
jenner039-2010.png, 696, 1080, 1776, 91, 0.102477477477, 100, 97, 0, 0
jenner040-2010.png, 1409, 1624, 3033, 170, 0.112100230795, 190, 196, 0, 0
jenner041-2010.png, 1714, 2638, 4352, 216, 0.0992647058824, 244, 253, 0, 0
jenner042-2010.png, 2330, 3287, 5617, 330, 0.117500445077, 358, 369, 0, 0
jenner043-2010.png, 1837, 2104, 3941, 233, 0.118244100482, 259, 255, 0, 0
jenner044-2010.png, 1252, 1622, 2874, 247, 0.171885873347, 276, 271, 0, 0
jenner045-2010.png, 1716, 2609, 4325, 223, 0.103121387283, 244, 250, 0, 0
jenner046-2010.png, 1451, 2089, 3540, 372, 0.210169491525, 404, 425, 0, 0
jenner047-2010.png, 1014, 1515, 2529, 185, 0.146302886516, 203, 197, 0, 0
jenner048-2010.png, 1846, 2204, 4050, 271, 0.133827160494, 290, 312, 0, 0
jenner049-2010.png, 1557, 2156, 3713, 264, 0.142203070294, 296, 289, 0, 0
jenner050-2010.png, 1402, 2452, 3854, 227, 0.117799688635, 251, 270, 0, 0
jenner051-2010.png, 1574, 1691, 3265, 158, 0.0967840735069, 175, 177, 0, 0
jenner052-2010.png, 1055, 1464, 2519, 268, 0.212782850337, 287, 292, 0, 0
jenner053-2010.png, 1217, 2040, 3257, 185, 0.113601473749, 201, 206, 0, 0
jenner054-2010.png, 973, 1232, 2205, 146, 0.132426303855, 165, 167, 0, 0
jenner055-2010.png, 873, 1112, 1985, 168, 0.169269521411, 185, 186, 0, 0
jenner056-2010.png, 1274, 1235, 2509, 104, 0.0829015544041, 117, 118, 0, 0
jenner057-2010.png, 1669, 2118, 3787, 376, 0.198574069184, 403, 397, 0, 0
jenner058-2010.png, 1323, 2490, 3813, 286, 0.150013113034, 309, 321, 0, 0
jenner059-2010.png, 1574, 1846, 3420, 242, 0.141520467836, 276, 267, 0, 0
jenner060-2010.png, 802, 1118, 1920, 75, 0.078125, 82, 91, 0, 0
jenner061-2010.png, 825, 1575, 2400, 60, 0.05, 70, 73, 0, 0
jenner062-2010.png, 694, 852, 1546, 105, 0.135834411384, 112, 110, 0, 0
jenner063-2010.png, 1019, 1445, 2464, 201, 0.163149350649, 212, 216, 0, 0
jenner064-2010.png, 1339, 1389, 2728, 146, 0.107038123167, 165, 161, 0, 0
losangeles001-2010.png, 2652, 3887, 6539, 181, 0.0553601468114, 229, 252, 0, 0
losangeles002-2010.png, 3483, 5272, 8755, 431, 0.0984580239863, 488, 512, 0, 0
losangeles003-2010.png, 1543, 4002, 5545, 378, 0.136339044184, 418, 431, 0, 0
losangeles004-2010.png, 859, 3242, 4101, 141, 0.0687637161668, 153, 168, 0, 0
losangeles005-2010.png, 1553, 3940, 5493, 405, 0.147460404151, 430, 465, 0, 0
losangeles006-2010.png, 2221, 4441, 6662, 500, 0.150105073551, 531, 564, 0, 0
losangeles007-2010.png, 2574, 4033, 6607, 806, 0.243983653701, 865, 880, 0, 0
losangeles008-2010.png, 2523, 4400, 6923, 766, 0.221291347682, 810, 842, 0, 0
losangeles009-2010.png, 2991, 4928, 7919, 173, 0.0436923854022, 215, 243, 0, 0
losangeles010-2010.png, 3131, 4900, 8031, 575, 0.143195118914, 611, 638, 0, 0
losangeles011-2010.png, 2256, 4714, 6970, 686, 0.196843615495, 725, 762, 0, 0
losangeles012-2010.png, 1949, 3447, 5396, 495, 0.183469236471, 537, 559, 0, 0
losangeles013-2010.png, 2156, 4206, 6362, 591, 0.185790631877, 641, 653, 0, 0
losangeles014-2010.png, 3267, 4918, 8185, 893, 0.218204031765, 961, 977, 0, 0
losangeles015-2010.png, 1268, 3012, 4280, 386, 0.180373831776, 414, 441, 0, 0
losangeles016-2010.png, 2223, 4318, 6541, 630, 0.192631096163, 660, 684, 0, 0
losangeles017-2010.png, 3041, 4339, 7380, 220, 0.059620596206, 256, 281, 0, 0
losangeles018-2010.png, 3006, 3988, 6994, 658, 0.188161281098, 735, 727, 0, 0
losangeles019-2010.png, 1602, 3494, 5096, 433, 0.169937205651, 470, 500, 0, 0
losangeles020-2010.png, 2064, 3761, 5825, 563, 0.19330472103, 602, 650, 0, 0
losangeles021-2010.png, 2047, 3487, 5534, 476, 0.17202746657, 520, 557, 0, 0
losangeles022-2010.png, 2921, 4660, 7581, 753, 0.198654531065, 808, 833, 0, 0
losangeles023-2010.png, 2287, 4216, 6503, 688, 0.211594648624, 719, 758, 0, 0
losangeles024-2010.png, 3000, 4667, 7667, 844, 0.220164340681, 882, 908, 0, 0
losangeles025-2010.png, 2780, 4262, 7042, 154, 0.0437375745527, 185, 232, 0, 0
losangeles026-2010.png, 3032, 4477, 7509, 526, 0.140098548409, 588, 605, 0, 0
losangeles027-2010.png, 1900, 3756, 5656, 557, 0.196958981612, 606, 616, 0, 0
losangeles028-2010.png, 1906, 3437, 5343, 576, 0.21560920831, 607, 629, 0, 0
losangeles029-2010.png, 2505, 3428, 5933, 677, 0.228215068262, 734, 764, 0, 0
losangeles030-2010.png, 2826, 4570, 7396, 696, 0.188209843158, 750, 786, 0, 0
losangeles031-2010.png, 2801, 4265, 7066, 830, 0.23492782338, 887, 909, 0, 0
losangeles032-2010.png, 2842, 4524, 7366, 781, 0.212055389628, 838, 861, 0, 0
losangeles033-2010.png, 3208, 4557, 7765, 221, 0.0569220862846, 266, 297, 0, 0
losangeles034-2010.png, 3517, 4684, 8201, 276, 0.0673088647726, 317, 343, 0, 0
losangeles035-2010.png, 1880, 4075, 5955, 522, 0.175314861461, 566, 589, 0, 0
losangeles036-2010.png, 2171, 4057, 6228, 562, 0.180475272961, 603, 621, 0, 0
losangeles037-2010.png, 2257, 4127, 6384, 571, 0.178884711779, 624, 650, 0, 0
losangeles038-2010.png, 2689, 4340, 7029, 692, 0.196898563096, 753, 773, 0, 0
losangeles039-2010.png, 2771, 4325, 7096, 856, 0.241262683202, 921, 935, 0, 0
losangeles040-2010.png, 2889, 4516, 7405, 826, 0.223092505064, 885, 923, 0, 0
losangeles041-2010.png, 3702, 4877, 8579, 194, 0.0452267164005, 244, 258, 0, 0
losangeles042-2010.png, 3358, 4090, 7448, 505, 0.135606874329, 554, 578, 0, 0
losangeles043-2010.png, 1671, 3389, 5060, 380, 0.150197628458, 411, 452, 0, 0
losangeles044-2010.png, 2012, 3852, 5864, 440, 0.150068212824, 464, 491, 0, 0
losangeles045-2010.png, 2529, 4177, 6706, 496, 0.147927229347, 538, 556, 0, 0
losangeles046-2010.png, 2665, 4088, 6753, 616, 0.182437435214, 684, 700, 0, 0
losangeles047-2010.png, 2694, 4113, 6807, 866, 0.254443954752, 919, 926, 0, 0
losangeles048-2010.png, 2586, 4387, 6973, 722, 0.207084468665, 766, 793, 0, 0
losangeles049-2010.png, 3307, 4363, 7670, 160, 0.0417209908735, 215, 215, 0, 0
losangeles050-2010.png, 3247, 4106, 7353, 626, 0.170270637835, 698, 711, 0, 0
losangeles051-2010.png, 2414, 4105, 6519, 489, 0.150023009664, 538, 575, 0, 0
losangeles052-2010.png, 2612, 4296, 6908, 554, 0.160393746381, 625, 620, 0, 0
losangeles053-2010.png, 2787, 4052, 6839, 632, 0.184822342448, 694, 725, 0, 0
losangeles054-2010.png, 3211, 4604, 7815, 814, 0.208317338452, 878, 891, 0, 0
losangeles055-2010.png, 2787, 4238, 7025, 936, 0.266476868327, 978, 988, 0, 0
losangeles056-2010.png, 2536, 3893, 6429, 657, 0.204386374242, 700, 712, 0, 0
losangeles057-2010.png, 3192, 4368, 7560, 195, 0.0515873015873, 241, 250, 0, 0
losangeles058-2010.png, 3250, 4647, 7897, 489, 0.123844497911, 524, 556, 0, 0
losangeles059-2010.png, 2553, 4739, 7292, 458, 0.125617114646, 498, 517, 0, 0
losangeles060-2010.png, 3223, 4841, 8064, 817, 0.202628968254, 857, 898, 0, 0
losangeles061-2010.png, 2890, 4220, 7110, 699, 0.196624472574, 757, 760, 0, 0
losangeles062-2010.png, 3131, 4542, 7673, 746, 0.194448064642, 808, 822, 0, 0
losangeles063-2010.png, 2506, 4205, 6711, 753, 0.224407688869, 804, 812, 0, 0
losangeles064-2010.png, 2963, 4401, 7364, 726, 0.197175448126, 795, 793, 0, 0
merced001-2010.png, 3614, 4717, 8331, 429, 0.102988836874, 472, 503, 0, 0
merced002-2010.png, 3585, 4355, 7940, 134, 0.0337531486146, 167, 180, 0, 0
merced003-2010.png, 866, 1387, 2253, 108, 0.0958721704394, 129, 130, 0, 0
merced004-2010.png, 1039, 1357, 2396, 168, 0.140233722871, 204, 214, 0, 0
merced005-2010.png, 597, 734, 1331, 101, 0.151765589782, 118, 120, 0, 0
merced006-2010.png, 360, 637, 997, 26, 0.0521564694082, 33, 43, 0, 0
merced007-2010.png, 291, 504, 795, 13, 0.0327044025157, 24, 21, 0, 0
merced008-2010.png, 239, 227, 466, 22, 0.0944206008584, 28, 25, 0, 0
merced009-2010.png, 2814, 4533, 7347, 319, 0.0868381652375, 351, 388, 0, 0
merced010-2010.png, 2709, 4229, 6938, 174, 0.0501585471317, 209, 209, 0, 0
merced011-2010.png, 675, 964, 1639, 36, 0.0439292251373, 47, 52, 0, 0
merced012-2010.png, 881, 1129, 2010, 118, 0.117412935323, 144, 148, 0, 0
merced013-2010.png, 603, 621, 1224, 33, 0.0539215686275, 46, 47, 0, 0
merced014-2010.png, 823, 1493, 2316, 76, 0.0656303972366, 92, 103, 0, 0
merced015-2010.png, 419, 1038, 1457, 77, 0.105696636925, 91, 94, 0, 0
merced016-2010.png, 550, 767, 1317, 100, 0.151860288535, 118, 122, 0, 0
merced017-2010.png, 1047, 2001, 3048, 103, 0.0675853018373, 117, 145, 0, 0
merced018-2010.png, 1128, 1834, 2962, 62, 0.0418636056718, 75, 87, 0, 0
merced019-2010.png, 551, 690, 1241, 11, 0.0177276390008, 16, 22, 0, 0
merced020-2010.png, 432, 405, 837, 43, 0.1027479092, 52, 52, 0, 0
merced021-2010.png, 758, 274, 1032, 10, 0.0193798449612, 17, 11, 0, 0
merced022-2010.png, 796, 359, 1155, 37, 0.0640692640693, 45, 43, 0, 0
merced023-2010.png, 452, 578, 1030, 40, 0.0776699029126, 48, 66, 0, 0
merced024-2010.png, 149, 500, 649, 15, 0.0462249614792, 19, 26, 0, 0
merced025-2010.png, 611, 1318, 1929, 44, 0.0456194919647, 53, 84, 0, 0
merced026-2010.png, 1003, 1194, 2197, 79, 0.071916249431, 101, 102, 0, 0
merced027-2010.png, 1030, 1011, 2041, 50, 0.0489955903969, 71, 64, 0, 0
merced028-2010.png, 640, 252, 892, 9, 0.0201793721973, 16, 15, 0, 0
merced029-2010.png, 1684, 112, 1796, 11, 0.0122494432071, 19, 11, 0, 0
merced030-2010.png, 1582, 98, 1680, 3, 0.00357142857143, 8, 3, 0, 0
merced031-2010.png, 481, 670, 1151, 51, 0.0886185925282, 60, 61, 0, 0
merced032-2010.png, 269, 356, 625, 10, 0.032, 12, 11, 0, 0
merced033-2010.png, 1256, 1512, 2768, 245, 0.177023121387, 274, 276, 0, 0
merced034-2010.png, 935, 1218, 2153, 44, 0.0408732001858, 59, 60, 0, 0
merced035-2010.png, 626, 375, 1001, 29, 0.0579420579421, 41, 34, 0, 0
merced036-2010.png, 1367, 490, 1857, 85, 0.0915455035003, 116, 96, 0, 0
merced037-2010.png, 2973, 968, 3941, 173, 0.0877949758944, 214, 191, 0, 0
merced038-2010.png, 1850, 186, 2036, 20, 0.0196463654224, 27, 20, 0, 0
merced039-2010.png, 784, 472, 1256, 54, 0.0859872611465, 71, 62, 0, 0
merced040-2010.png, 438, 352, 790, 18, 0.0455696202532, 23, 20, 0, 0
merced041-2010.png, 1033, 1113, 2146, 169, 0.157502329916, 208, 202, 0, 0
merced042-2010.png, 1031, 599, 1630, 29, 0.0355828220859, 46, 43, 0, 0
merced043-2010.png, 1092, 158, 1250, 22, 0.0352, 29, 25, 0, 0
merced044-2010.png, 1433, 291, 1724, 24, 0.0278422273782, 38, 27, 0, 0
merced045-2010.png, 3179, 746, 3925, 149, 0.075923566879, 186, 160, 0, 0
merced046-2010.png, 2300, 284, 2584, 41, 0.03173374613, 60, 43, 0, 0
merced047-2010.png, 916, 754, 1670, 137, 0.164071856287, 155, 156, 0, 0
merced048-2010.png, 916, 1210, 2126, 69, 0.0649106302916, 83, 94, 0, 0
merced049-2010.png, 351, 627, 978, 56, 0.114519427403, 66, 73, 0, 0
merced050-2010.png, 563, 248, 811, 39, 0.0961775585697, 53, 55, 0, 0
merced051-2010.png, 1085, 213, 1298, 20, 0.0308166409861, 29, 23, 0, 0
merced052-2010.png, 2085, 186, 2271, 17, 0.0149713782475, 31, 20, 0, 0
merced053-2010.png, 2232, 193, 2425, 22, 0.0181443298969, 38, 22, 0, 0
merced054-2010.png, 1796, 115, 1911, 6, 0.00627943485086, 14, 9, 0, 0
merced055-2010.png, 488, 329, 817, 40, 0.0979192166463, 46, 43, 0, 0
merced056-2010.png, 502, 681, 1183, 10, 0.0169061707523, 12, 14, 0, 0
merced057-2010.png, 477, 226, 703, 11, 0.0312944523471, 17, 12, 0, 0
merced058-2010.png, 440, 32, 472, 11, 0.0466101694915, 17, 13, 0, 0
merced059-2010.png, 655, 203, 858, 22, 0.0512820512821, 30, 30, 0, 0
merced060-2010.png, 1006, 157, 1163, 10, 0.0171969045572, 15, 13, 0, 0
merced061-2010.png, 898, 436, 1334, 21, 0.0314842578711, 32, 26, 0, 0
merced062-2010.png, 1459, 270, 1729, 27, 0.0312319259688, 32, 30, 0, 0
merced063-2010.png, 1310, 317, 1627, 23, 0.0282728948986, 39, 28, 0, 0
merced064-2010.png, 964, 643, 1607, 21, 0.0261356565028, 40, 33, 0, 0
oakland001-2010.png, 2989, 3138, 6127, 191, 0.0623469887384, 228, 227, 0, 0
oakland002-2010.png, 3766, 3458, 7224, 265, 0.0733665559247, 319, 316, 0, 0
oakland003-2010.png, 3959, 4543, 8502, 461, 0.108445071748, 551, 535, 0, 0
oakland004-2010.png, 3764, 4701, 8465, 474, 0.111990549321, 537, 558, 0, 0
oakland005-2010.png, 3288, 3700, 6988, 398, 0.113909559244, 440, 446, 0, 0
oakland006-2010.png, 1843, 1707, 3550, 111, 0.0625352112676, 125, 132, 0, 0
oakland007-2010.png, 1333, 2282, 3615, 332, 0.183679114799, 355, 382, 0, 0
oakland008-2010.png, 1334, 2175, 3509, 502, 0.286121402109, 533, 536, 0, 0
oakland009-2010.png, 2242, 2408, 4650, 122, 0.0524731182796, 156, 150, 0, 0
oakland010-2010.png, 3436, 4128, 7564, 392, 0.103648863035, 439, 466, 0, 0
oakland011-2010.png, 3339, 4512, 7851, 210, 0.0534963698892, 245, 268, 0, 0
oakland012-2010.png, 3637, 4623, 8260, 233, 0.056416464891, 264, 293, 0, 0
oakland013-2010.png, 2815, 2466, 5281, 40, 0.0151486460898, 45, 55, 0, 0
oakland014-2010.png, 1872, 2003, 3875, 141, 0.0727741935484, 170, 173, 0, 0
oakland015-2010.png, 2309, 3482, 5791, 487, 0.168192022103, 533, 543, 0, 0
oakland016-2010.png, 1308, 2239, 3547, 362, 0.204116154497, 391, 401, 0, 0
oakland017-2010.png, 2584, 2835, 5419, 176, 0.0649566340653, 214, 210, 0, 0
oakland018-2010.png, 3244, 4412, 7656, 407, 0.10632183908, 466, 474, 0, 0
oakland019-2010.png, 3565, 4477, 8042, 353, 0.0877891071873, 417, 411, 0, 0
oakland020-2010.png, 3304, 4192, 7496, 135, 0.0360192102455, 154, 181, 0, 0
oakland021-2010.png, 2134, 2743, 4877, 188, 0.0770965757638, 206, 251, 0, 0
oakland022-2010.png, 3899, 4671, 8570, 511, 0.119253208868, 578, 615, 0, 0
oakland023-2010.png, 3172, 4414, 7586, 747, 0.196941734775, 797, 825, 0, 0
oakland024-2010.png, 1401, 2412, 3813, 351, 0.18410700236, 389, 396, 0, 0
oakland025-2010.png, 3430, 3866, 7296, 224, 0.0614035087719, 271, 273, 0, 0
oakland026-2010.png, 4027, 4627, 8654, 518, 0.119713427317, 574, 578, 0, 0
oakland027-2010.png, 2772, 3386, 6158, 166, 0.0539136083144, 197, 208, 0, 0
oakland028-2010.png, 2167, 2671, 4838, 155, 0.0640760644895, 173, 199, 0, 0
oakland029-2010.png, 3239, 4225, 7464, 343, 0.0919078242229, 395, 409, 0, 0
oakland030-2010.png, 3254, 4182, 7436, 509, 0.136901559978, 580, 607, 0, 0
oakland031-2010.png, 1321, 2602, 3923, 321, 0.163650267652, 342, 365, 0, 0
oakland032-2010.png, 3537, 4940, 8477, 970, 0.228854547599, 1033, 1072, 0, 0
oakland033-2010.png, 3634, 4319, 7953, 237, 0.0596001508865, 270, 288, 0, 0
oakland034-2010.png, 3519, 5195, 8714, 359, 0.0823961441359, 397, 429, 0, 0
oakland035-2010.png, 3092, 3315, 6407, 242, 0.0755423755268, 279, 293, 0, 0
oakland036-2010.png, 2712, 3483, 6195, 205, 0.0661824051655, 234, 249, 0, 0
oakland037-2010.png, 3748, 4846, 8594, 552, 0.128461717477, 631, 641, 0, 0
oakland038-2010.png, 2501, 3545, 6046, 519, 0.171683757856, 576, 594, 0, 0
oakland039-2010.png, 3403, 4958, 8361, 975, 0.233225690707, 1022, 1068, 0, 0
oakland040-2010.png, 3821, 5340, 9161, 1171, 0.255648946622, 1241, 1252, 0, 0
oakland041-2010.png, 3164, 4331, 7495, 246, 0.0656437625083, 283, 307, 0, 0
oakland042-2010.png, 2940, 3654, 6594, 192, 0.0582347588717, 225, 231, 0, 0
oakland043-2010.png, 2594, 2647, 5241, 342, 0.130509444762, 387, 388, 0, 0
oakland044-2010.png, 2818, 3468, 6286, 387, 0.123130766783, 450, 455, 0, 0
oakland045-2010.png, 3709, 4921, 8630, 429, 0.0994206257242, 491, 498, 0, 0
oakland046-2010.png, 3168, 4192, 7360, 443, 0.120380434783, 495, 516, 0, 0
oakland047-2010.png, 2838, 4199, 7037, 758, 0.215432712804, 803, 835, 0, 0
oakland048-2010.png, 3205, 4888, 8093, 936, 0.231311009514, 972, 1034, 0, 0
oakland049-2010.png, 3579, 3883, 7462, 203, 0.0544090056285, 246, 245, 0, 0
oakland050-2010.png, 1630, 2204, 3834, 88, 0.0459050599896, 99, 124, 0, 0
oakland051-2010.png, 1742, 2075, 3817, 150, 0.0785957558292, 183, 191, 0, 0
oakland052-2010.png, 1326, 1844, 3170, 133, 0.0839116719243, 148, 166, 0, 0
oakland053-2010.png, 2159, 2586, 4745, 264, 0.111275026344, 308, 319, 0, 0
oakland054-2010.png, 1849, 2493, 4342, 259, 0.119299861815, 292, 304, 0, 0
oakland055-2010.png, 3001, 4104, 7105, 857, 0.241238564391, 896, 940, 0, 0
oakland056-2010.png, 3496, 5191, 8687, 1057, 0.243352135375, 1121, 1138, 0, 0
oakland057-2010.png, 1404, 1753, 3157, 59, 0.0373772568895, 67, 74, 0, 0
oakland058-2010.png, 2431, 2386, 4817, 146, 0.0606186423085, 176, 174, 0, 0
oakland059-2010.png, 2031, 2070, 4101, 162, 0.0790051207023, 191, 203, 0, 0
oakland060-2010.png, 2257, 2556, 4813, 206, 0.0856014959485, 233, 239, 0, 0
oakland061-2010.png, 2099, 3130, 5229, 275, 0.105182635303, 314, 341, 0, 0
oakland062-2010.png, 1334, 2235, 3569, 235, 0.131689548893, 259, 280, 0, 0
oakland063-2010.png, 2221, 3204, 5425, 615, 0.226728110599, 658, 687, 0, 0
oakland064-2010.png, 4014, 5421, 9435, 1076, 0.22808691044, 1160, 1162, 0, 0
petaluma001-2010.png, 1518, 2032, 3550, 433, 0.243943661972, 465, 483, 0, 0
petaluma002-2010.png, 3415, 4385, 7800, 995, 0.255128205128, 1049, 1087, 0, 0
petaluma003-2010.png, 1406, 2487, 3893, 258, 0.132545594657, 293, 321, 0, 0
petaluma004-2010.png, 1390, 1657, 3047, 103, 0.0676074827699, 137, 140, 0, 0
petaluma005-2010.png, 1123, 1444, 2567, 62, 0.0483054148812, 75, 90, 0, 0
petaluma006-2010.png, 718, 947, 1665, 54, 0.0648648648649, 64, 72, 0, 0
petaluma007-2010.png, 1610, 2162, 3772, 210, 0.111346765642, 232, 255, 0, 0
petaluma008-2010.png, 1232, 2043, 3275, 102, 0.0622900763359, 125, 132, 0, 0
petaluma009-2010.png, 3565, 4461, 8026, 1009, 0.251432843259, 1064, 1072, 0, 0
petaluma010-2010.png, 2965, 3831, 6796, 844, 0.248381400824, 894, 899, 0, 0
petaluma011-2010.png, 2666, 3794, 6460, 589, 0.182352941176, 634, 655, 0, 0
petaluma012-2010.png, 779, 1512, 2291, 44, 0.0384111741598, 53, 68, 0, 0
petaluma013-2010.png, 798, 1501, 2299, 16, 0.0139190952588, 21, 28, 0, 0
petaluma014-2010.png, 1345, 1961, 3306, 179, 0.108287961283, 207, 221, 0, 0
petaluma015-2010.png, 952, 1561, 2513, 165, 0.131317150816, 184, 193, 0, 0
petaluma016-2010.png, 1339, 1820, 3159, 151, 0.0955998733777, 175, 187, 0, 0
petaluma017-2010.png, 3437, 4567, 8004, 724, 0.180909545227, 786, 819, 0, 0
petaluma018-2010.png, 3397, 4381, 7778, 665, 0.170995114425, 727, 749, 0, 0
petaluma019-2010.png, 2056, 3195, 5251, 365, 0.139021138831, 401, 428, 0, 0
petaluma020-2010.png, 1478, 1982, 3460, 131, 0.0757225433526, 160, 159, 0, 0
petaluma021-2010.png, 1517, 1790, 3307, 233, 0.140913214394, 251, 266, 0, 0
petaluma022-2010.png, 2163, 2846, 5009, 540, 0.215611898583, 587, 602, 0, 0
petaluma023-2010.png, 1679, 2263, 3942, 192, 0.0974124809741, 221, 228, 0, 0
petaluma024-2010.png, 1921, 2616, 4537, 231, 0.101829402689, 265, 280, 0, 0
petaluma025-2010.png, 2577, 3550, 6127, 551, 0.179859637669, 605, 627, 0, 0
petaluma026-2010.png, 1689, 2616, 4305, 256, 0.118931475029, 290, 306, 0, 0
petaluma027-2010.png, 1227, 1649, 2876, 168, 0.116828929068, 193, 205, 0, 0
petaluma028-2010.png, 1489, 2067, 3556, 138, 0.0776152980877, 164, 184, 0, 0
petaluma029-2010.png, 1835, 2455, 4290, 378, 0.176223776224, 428, 437, 0, 0
petaluma030-2010.png, 1688, 2296, 3984, 380, 0.190763052209, 410, 425, 0, 0
petaluma031-2010.png, 1246, 1883, 3129, 96, 0.0613614573346, 117, 135, 0, 0
petaluma032-2010.png, 2711, 3610, 6321, 200, 0.063281126404, 238, 246, 0, 0
petaluma033-2010.png, 2593, 3051, 5644, 379, 0.134301913536, 430, 449, 0, 0
petaluma034-2010.png, 1164, 1613, 2777, 144, 0.103709038531, 160, 173, 0, 0
petaluma035-2010.png, 1790, 2128, 3918, 206, 0.105155691679, 247, 245, 0, 0
petaluma036-2010.png, 1683, 2593, 4276, 163, 0.0762394761459, 187, 220, 0, 0
petaluma037-2010.png, 2840, 3505, 6345, 611, 0.192592592593, 660, 697, 0, 0
petaluma038-2010.png, 2642, 3573, 6215, 610, 0.196299275945, 667, 677, 0, 0
petaluma039-2010.png, 3455, 4503, 7958, 306, 0.0769037446595, 355, 378, 0, 0
petaluma040-2010.png, 3066, 4054, 7120, 288, 0.0808988764045, 334, 355, 0, 0
petaluma041-2010.png, 1303, 1948, 3251, 203, 0.124884650877, 220, 228, 0, 0
petaluma042-2010.png, 1729, 2453, 4182, 394, 0.188426590148, 420, 444, 0, 0
petaluma043-2010.png, 1986, 2923, 4909, 406, 0.165410470564, 448, 476, 0, 0
petaluma044-2010.png, 2176, 3125, 5301, 337, 0.127145821543, 371, 416, 0, 0
petaluma045-2010.png, 2082, 2531, 4613, 337, 0.146108822892, 369, 389, 0, 0
petaluma046-2010.png, 2552, 3426, 5978, 434, 0.145199063232, 481, 497, 0, 0
petaluma047-2010.png, 3885, 5064, 8949, 519, 0.115990613476, 579, 600, 0, 0
petaluma048-2010.png, 1811, 2659, 4470, 369, 0.165100671141, 407, 426, 0, 0
petaluma049-2010.png, 2021, 2825, 4846, 349, 0.144036318613, 389, 407, 0, 0
petaluma050-2010.png, 2065, 2953, 5018, 396, 0.1578318055, 438, 463, 0, 0
petaluma051-2010.png, 2080, 2924, 5004, 468, 0.187050359712, 513, 523, 0, 0
petaluma052-2010.png, 1628, 2206, 3834, 167, 0.0871152842984, 194, 203, 0, 0
petaluma053-2010.png, 1571, 1428, 2999, 82, 0.054684894965, 104, 98, 0, 0
petaluma054-2010.png, 2505, 3392, 5897, 366, 0.124130914024, 412, 419, 0, 0
petaluma055-2010.png, 2539, 3373, 5912, 564, 0.190798376184, 619, 637, 0, 0
petaluma056-2010.png, 2041, 2862, 4903, 357, 0.145625127473, 398, 420, 0, 0
petaluma057-2010.png, 952, 1376, 2328, 141, 0.121134020619, 159, 176, 0, 0
petaluma058-2010.png, 2040, 2887, 4927, 381, 0.154658006901, 420, 441, 0, 0
petaluma059-2010.png, 1916, 2948, 4864, 393, 0.161595394737, 430, 454, 0, 0
petaluma060-2010.png, 1321, 1484, 2805, 117, 0.083422459893, 143, 145, 0, 0
petaluma061-2010.png, 2235, 2453, 4688, 213, 0.0908703071672, 249, 260, 0, 0
petaluma062-2010.png, 2852, 3838, 6690, 452, 0.135127055306, 510, 542, 0, 0
petaluma063-2010.png, 1573, 1679, 3252, 197, 0.121156211562, 234, 225, 0, 0
petaluma064-2010.png, 1714, 2169, 3883, 332, 0.17100180273, 369, 367, 0, 0
sanjose001-2010.png, 4089, 4742, 8831, 288, 0.065224776356, 349, 354, 0, 0
sanjose002-2010.png, 3843, 4453, 8296, 278, 0.0670202507232, 345, 348, 0, 0
sanjose003-2010.png, 3427, 4393, 7820, 267, 0.0682864450128, 315, 324, 0, 0
sanjose004-2010.png, 2783, 3433, 6216, 473, 0.152187902188, 535, 528, 0, 0
sanjose005-2010.png, 3464, 4760, 8224, 439, 0.106760700389, 488, 505, 0, 0
sanjose006-2010.png, 3075, 4312, 7387, 706, 0.191146608908, 757, 769, 0, 0
sanjose007-2010.png, 2895, 3941, 6836, 701, 0.205090696314, 745, 744, 0, 0
sanjose008-2010.png, 1147, 2234, 3381, 358, 0.211771665188, 375, 403, 0, 0
sanjose009-2010.png, 3784, 4763, 8547, 197, 0.046098046098, 241, 241, 0, 0
sanjose010-2010.png, 3486, 4553, 8039, 206, 0.051250155492, 247, 264, 0, 0
sanjose011-2010.png, 4003, 4493, 8496, 261, 0.0614406779661, 313, 324, 0, 0
sanjose012-2010.png, 2850, 3896, 6746, 344, 0.101986362289, 403, 409, 0, 0
sanjose013-2010.png, 2897, 3797, 6694, 311, 0.0929190319689, 352, 375, 0, 0
sanjose014-2010.png, 2972, 4039, 7011, 515, 0.146911995436, 567, 597, 0, 0
sanjose015-2010.png, 2593, 3407, 6000, 497, 0.165666666667, 536, 562, 0, 0
sanjose016-2010.png, 1526, 2923, 4449, 372, 0.167228590695, 404, 431, 0, 0
sanjose017-2010.png, 3556, 4285, 7841, 202, 0.051524040301, 252, 252, 0, 0
sanjose018-2010.png, 2410, 3050, 5460, 254, 0.0930402930403, 293, 307, 0, 0
sanjose019-2010.png, 2999, 4055, 7054, 204, 0.0578395236745, 255, 254, 0, 0
sanjose020-2010.png, 2843, 3908, 6751, 322, 0.0953932750704, 363, 377, 0, 0
sanjose021-2010.png, 3125, 4461, 7586, 381, 0.100448194042, 427, 440, 0, 0
sanjose022-2010.png, 3029, 3823, 6852, 621, 0.181260945709, 684, 684, 0, 0
sanjose023-2010.png, 1215, 1776, 2991, 260, 0.173854898027, 293, 297, 0, 0
sanjose024-2010.png, 1019, 2247, 3266, 185, 0.113288426209, 199, 227, 0, 0
sanjose025-2010.png, 2756, 3204, 5960, 313, 0.105033557047, 363, 363, 0, 0
sanjose026-2010.png, 3509, 3989, 7498, 378, 0.10082688717, 459, 436, 0, 0
sanjose027-2010.png, 3107, 3595, 6702, 356, 0.106236944196, 409, 424, 0, 0
sanjose028-2010.png, 3523, 4455, 7978, 584, 0.14640260717, 652, 673, 0, 0
sanjose029-2010.png, 3476, 4812, 8288, 482, 0.116312741313, 536, 551, 0, 0
sanjose030-2010.png, 2190, 2933, 5123, 468, 0.182705446028, 504, 520, 0, 0
sanjose031-2010.png, 1781, 2446, 4227, 453, 0.214336408801, 483, 498, 0, 0
sanjose032-2010.png, 1512, 3203, 4715, 422, 0.179003181336, 440, 485, 0, 0
sanjose033-2010.png, 3542, 4048, 7590, 217, 0.0571805006588, 275, 267, 0, 0
sanjose034-2010.png, 3586, 3914, 7500, 422, 0.112533333333, 486, 487, 0, 0
sanjose035-2010.png, 3347, 4015, 7362, 429, 0.116544417278, 504, 507, 0, 0
sanjose036-2010.png, 3005, 4109, 7114, 414, 0.116390216475, 475, 477, 0, 0
sanjose037-2010.png, 3244, 4800, 8044, 566, 0.140726006962, 611, 662, 0, 0
sanjose038-2010.png, 1161, 1945, 3106, 393, 0.253058596265, 416, 437, 0, 0
sanjose039-2010.png, 1406, 2189, 3595, 372, 0.206954102921, 394, 406, 0, 0
sanjose040-2010.png, 2178, 3845, 6023, 553, 0.183629420555, 586, 610, 0, 0
sanjose041-2010.png, 3267, 3635, 6902, 239, 0.0692552883222, 289, 301, 0, 0
sanjose042-2010.png, 2688, 3498, 6186, 308, 0.0995796960879, 347, 366, 0, 0
sanjose043-2010.png, 3047, 3599, 6646, 510, 0.153475774902, 575, 575, 0, 0
sanjose044-2010.png, 3155, 3948, 7103, 379, 0.106715472336, 437, 439, 0, 0
sanjose045-2010.png, 1081, 1723, 2804, 79, 0.0563480741797, 93, 113, 0, 0
sanjose046-2010.png, 730, 1526, 2256, 221, 0.195921985816, 237, 256, 0, 0
sanjose047-2010.png, 1653, 2715, 4368, 459, 0.210164835165, 488, 503, 0, 0
sanjose048-2010.png, 2316, 4241, 6557, 601, 0.183315540644, 637, 664, 0, 0
sanjose049-2010.png, 1880, 2568, 4448, 115, 0.0517086330935, 142, 163, 0, 0
sanjose050-2010.png, 2725, 3625, 6350, 182, 0.0573228346457, 226, 233, 0, 0
sanjose051-2010.png, 3372, 4098, 7470, 406, 0.108701472557, 450, 475, 0, 0
sanjose052-2010.png, 1087, 1533, 2620, 143, 0.109160305344, 162, 175, 0, 0
sanjose053-2010.png, 857, 1452, 2309, 121, 0.104807275877, 141, 154, 0, 0
sanjose054-2010.png, 1426, 2007, 3433, 426, 0.248179434897, 467, 473, 0, 0
sanjose055-2010.png, 1708, 2702, 4410, 453, 0.205442176871, 488, 502, 0, 0
sanjose056-2010.png, 1700, 2766, 4466, 465, 0.208240035826, 503, 509, 0, 0
sanjose057-2010.png, 1056, 1594, 2650, 94, 0.0709433962264, 109, 120, 0, 0
sanjose058-2010.png, 2569, 3857, 6426, 309, 0.0961718020542, 357, 372, 0, 0
sanjose059-2010.png, 2177, 3161, 5338, 224, 0.0839265642563, 260, 274, 0, 0
sanjose060-2010.png, 1604, 2243, 3847, 103, 0.0535482193917, 118, 142, 0, 0
sanjose061-2010.png, 633, 1716, 2349, 57, 0.0485312899106, 66, 81, 0, 0
sanjose062-2010.png, 855, 2158, 3013, 316, 0.209757716562, 330, 351, 0, 0
sanjose063-2010.png, 1720, 2594, 4314, 503, 0.233194251275, 542, 534, 0, 0
sanjose064-2010.png, 1608, 3058, 4666, 610, 0.261465923703, 625, 650, 0, 0
sanysidro001-2010.png, 2929, 3887, 6816, 520, 0.152582159624, 580, 592, 0, 0
sanysidro002-2010.png, 3351, 3915, 7266, 531, 0.146160198183, 592, 601, 0, 0
sanysidro003-2010.png, 2731, 3602, 6333, 200, 0.0631612190115, 230, 254, 0, 0
sanysidro004-2010.png, 1731, 2318, 4049, 162, 0.0800197579649, 201, 218, 0, 0
sanysidro005-2010.png, 1283, 1560, 2843, 109, 0.076679563841, 132, 130, 0, 0
sanysidro006-2010.png, 666, 1372, 2038, 50, 0.0490677134446, 63, 67, 0, 0
sanysidro007-2010.png, 598, 1384, 1982, 42, 0.0423814328961, 50, 68, 0, 0
sanysidro008-2010.png, 727, 1467, 2194, 159, 0.144940747493, 177, 185, 0, 0
sanysidro009-2010.png, 2095, 2751, 4846, 455, 0.187783739166, 502, 526, 0, 0
sanysidro010-2010.png, 3881, 4405, 8286, 641, 0.1547188028, 740, 724, 0, 0
sanysidro011-2010.png, 2877, 3867, 6744, 224, 0.0664294187426, 267, 298, 0, 0
sanysidro012-2010.png, 1634, 1958, 3592, 109, 0.0606904231626, 141, 136, 0, 0
sanysidro013-2010.png, 558, 698, 1256, 50, 0.0796178343949, 61, 60, 0, 0
sanysidro014-2010.png, 808, 1888, 2696, 99, 0.0734421364985, 107, 133, 0, 0
sanysidro015-2010.png, 180, 834, 1014, 8, 0.0157790927022, 9, 11, 0, 0
sanysidro016-2010.png, 291, 1649, 1940, 78, 0.080412371134, 79, 92, 0, 0
sanysidro017-2010.png, 3045, 3530, 6575, 558, 0.169733840304, 624, 626, 0, 0
sanysidro018-2010.png, 4127, 4821, 8948, 520, 0.116227089852, 600, 598, 0, 0
sanysidro019-2010.png, 3574, 4596, 8170, 301, 0.0736842105263, 363, 359, 0, 0
sanysidro020-2010.png, 2980, 3542, 6522, 180, 0.0551977920883, 206, 240, 0, 0
sanysidro021-2010.png, 2035, 2809, 4844, 134, 0.0553261767135, 163, 175, 0, 0
sanysidro022-2010.png, 1085, 2054, 3139, 112, 0.0713603058299, 129, 146, 0, 0
sanysidro023-2010.png, 202, 764, 966, 14, 0.0289855072464, 15, 20, 0, 0
sanysidro024-2010.png, 146, 799, 945, 33, 0.0698412698413, 34, 44, 0, 0
sanysidro025-2010.png, 3607, 4474, 8081, 1044, 0.258383863383, 1118, 1124, 0, 0
sanysidro026-2010.png, 3983, 4920, 8903, 516, 0.115915983376, 576, 610, 0, 0
sanysidro027-2010.png, 2856, 3693, 6549, 240, 0.0732936326157, 284, 304, 0, 0
sanysidro028-2010.png, 3561, 4692, 8253, 459, 0.111232279171, 512, 551, 0, 0
sanysidro029-2010.png, 3078, 4189, 7267, 139, 0.0382551259117, 186, 202, 0, 0
sanysidro030-2010.png, 2414, 3781, 6195, 78, 0.025181598063, 110, 109, 0, 0
sanysidro031-2010.png, 210, 730, 940, 8, 0.0170212765957, 12, 18, 0, 0
sanysidro032-2010.png, 449, 802, 1251, 55, 0.087929656275, 72, 68, 0, 0
sanysidro033-2010.png, 3226, 4010, 7236, 866, 0.239358761747, 938, 957, 0, 0
sanysidro034-2010.png, 3811, 4598, 8409, 448, 0.10655250327, 508, 535, 0, 0
sanysidro035-2010.png, 3753, 4836, 8589, 261, 0.0607754104087, 325, 336, 0, 0
sanysidro036-2010.png, 3148, 4433, 7581, 200, 0.0527634876665, 231, 249, 0, 0
sanysidro037-2010.png, 3239, 4212, 7451, 210, 0.0563682727151, 253, 276, 0, 0
sanysidro038-2010.png, 1935, 3071, 5006, 99, 0.0395525369557, 117, 134, 0, 0
sanysidro039-2010.png, 216, 745, 961, 4, 0.00832466181061, 4, 6, 0, 0
sanysidro040-2010.png, 279, 521, 800, 5, 0.0125, 8, 5, 0, 0
sanysidro041-2010.png, 3507, 4336, 7843, 978, 0.249394364401, 1040, 1058, 0, 0
sanysidro042-2010.png, 3837, 4804, 8641, 438, 0.101377155422, 502, 510, 0, 0
sanysidro043-2010.png, 3642, 5027, 8669, 212, 0.0489099088707, 265, 267, 0, 0
sanysidro044-2010.png, 2487, 3070, 5557, 124, 0.0446283966169, 153, 163, 0, 0
sanysidro045-2010.png, 596, 1094, 1690, 48, 0.0568047337278, 56, 66, 0, 0
sanysidro046-2010.png, 927, 1838, 2765, 11, 0.00795660036166, 18, 17, 0, 0
sanysidro047-2010.png, 432, 1057, 1489, 39, 0.0523841504365, 45, 52, 0, 0
sanysidro048-2010.png, 640, 1130, 1770, 184, 0.20790960452, 193, 201, 0, 0
sanysidro049-2010.png, 3435, 4428, 7863, 655, 0.166603077706, 718, 712, 0, 0
sanysidro050-2010.png, 3434, 4417, 7851, 397, 0.101133613552, 447, 468, 0, 0
sanysidro051-2010.png, 3232, 4407, 7639, 197, 0.051577431601, 238, 238, 0, 0
sanysidro052-2010.png, 1819, 2814, 4633, 164, 0.070796460177, 184, 202, 0, 0
sanysidro053-2010.png, 177, 960, 1137, 12, 0.0211081794195, 16, 20, 0, 0
sanysidro054-2010.png, 635, 1655, 2290, 15, 0.0131004366812, 18, 22, 0, 0
sanysidro055-2010.png, 879, 1435, 2314, 35, 0.0302506482282, 42, 56, 0, 0
sanysidro056-2010.png, 947, 1701, 2648, 227, 0.171450151057, 246, 253, 0, 0
sanysidro057-2010.png, 3255, 4405, 7660, 793, 0.207049608355, 848, 894, 0, 0
sanysidro058-2010.png, 4302, 5361, 9663, 369, 0.0763737969575, 446, 449, 0, 0
sanysidro059-2010.png, 3754, 4984, 8738, 232, 0.0531013962005, 292, 291, 0, 0
sanysidro060-2010.png, 2901, 4120, 7021, 168, 0.0478564307079, 207, 210, 0, 0
sanysidro061-2010.png, 1911, 3185, 5096, 140, 0.0549450549451, 169, 180, 0, 0
sanysidro062-2010.png, 472, 1857, 2329, 30, 0.0257621296694, 32, 49, 0, 0
sanysidro063-2010.png, 1423, 2064, 3487, 77, 0.0441640378549, 91, 109, 0, 0
sanysidro064-2010.png, 2693, 3711, 6404, 564, 0.176139912555, 613, 640, 0, 0
yuba001-2010.png, 2187, 3703, 5890, 154, 0.0522920203735, 178, 201, 0, 0
yuba002-2010.png, 2821, 4520, 7341, 617, 0.168096989511, 670, 710, 0, 0
yuba003-2010.png, 1403, 2424, 3827, 251, 0.131173242749, 280, 293, 0, 0
yuba004-2010.png, 2289, 3116, 5405, 401, 0.148381128585, 452, 465, 0, 0
yuba005-2010.png, 432, 505, 937, 81, 0.172892209178, 100, 97, 0, 0
yuba006-2010.png, 1074, 1476, 2550, 119, 0.0933333333333, 154, 150, 0, 0
yuba007-2010.png, 847, 949, 1796, 101, 0.112472160356, 127, 133, 0, 0
yuba008-2010.png, 470, 413, 883, 28, 0.0634201585504, 37, 38, 0, 0
yuba009-2010.png, 2386, 4137, 6523, 168, 0.051510041392, 196, 221, 0, 0
yuba010-2010.png, 3008, 4599, 7607, 778, 0.204548442224, 820, 846, 0, 0
yuba011-2010.png, 2183, 3049, 5232, 382, 0.146024464832, 414, 440, 0, 0
yuba012-2010.png, 3032, 4028, 7060, 576, 0.163172804533, 637, 654, 0, 0
yuba013-2010.png, 1586, 2321, 3907, 270, 0.138213463015, 302, 309, 0, 0
yuba014-2010.png, 665, 869, 1534, 101, 0.131681877445, 131, 130, 0, 0
yuba015-2010.png, 735, 958, 1693, 97, 0.114589486119, 115, 125, 0, 0
yuba016-2010.png, 982, 462, 1444, 32, 0.0443213296399, 43, 39, 0, 0
yuba017-2010.png, 2010, 2982, 4992, 251, 0.100560897436, 289, 309, 0, 0
yuba018-2010.png, 3076, 4574, 7650, 827, 0.216209150327, 887, 910, 0, 0
yuba019-2010.png, 2724, 3919, 6643, 592, 0.178232726178, 657, 664, 0, 0
yuba020-2010.png, 1218, 2099, 3317, 289, 0.174253843835, 323, 342, 0, 0
yuba021-2010.png, 1147, 1853, 3000, 207, 0.138, 234, 256, 0, 0
yuba022-2010.png, 790, 1104, 1894, 114, 0.120380147835, 133, 142, 0, 0
yuba023-2010.png, 501, 938, 1439, 69, 0.0958999305073, 83, 90, 0, 0
yuba024-2010.png, 1111, 724, 1835, 63, 0.0686648501362, 81, 67, 0, 0
yuba025-2010.png, 2470, 3961, 6431, 214, 0.066552635671, 242, 267, 0, 0
yuba026-2010.png, 1641, 2936, 4577, 331, 0.144636224601, 361, 390, 0, 0
yuba027-2010.png, 2639, 3371, 6010, 495, 0.164725457571, 543, 555, 0, 0
yuba028-2010.png, 1622, 2541, 4163, 384, 0.184482344463, 418, 430, 0, 0
yuba029-2010.png, 934, 1920, 2854, 195, 0.136650315347, 221, 242, 0, 0
yuba030-2010.png, 1392, 1970, 3362, 139, 0.0826888756692, 170, 183, 0, 0
yuba031-2010.png, 1228, 1660, 2888, 135, 0.0934903047091, 150, 167, 0, 0
yuba032-2010.png, 994, 621, 1615, 43, 0.0532507739938, 59, 55, 0, 0
yuba033-2010.png, 740, 1318, 2058, 100, 0.0971817298348, 113, 131, 0, 0
yuba034-2010.png, 818, 1589, 2407, 152, 0.126298296635, 165, 189, 0, 0
yuba035-2010.png, 1338, 1736, 3074, 356, 0.231620039037, 386, 399, 0, 0
yuba036-2010.png, 570, 773, 1343, 109, 0.162323157111, 125, 131, 0, 0
yuba037-2010.png, 1793, 2551, 4344, 259, 0.119244935543, 294, 308, 0, 0
yuba038-2010.png, 2070, 2864, 4934, 203, 0.0822861775436, 241, 257, 0, 0
yuba039-2010.png, 1772, 2644, 4416, 204, 0.0923913043478, 241, 263, 0, 0
yuba040-2010.png, 1710, 2155, 3865, 110, 0.0569210866753, 133, 140, 0, 0
yuba041-2010.png, 654, 1225, 1879, 82, 0.0872804683342, 99, 105, 0, 0
yuba042-2010.png, 989, 1972, 2961, 157, 0.106045254981, 179, 188, 0, 0
yuba043-2010.png, 1009, 1204, 2213, 148, 0.133755083597, 172, 194, 0, 0
yuba044-2010.png, 468, 442, 910, 85, 0.186813186813, 100, 107, 0, 0
yuba045-2010.png, 856, 1129, 1985, 163, 0.164231738035, 189, 193, 0, 0
yuba046-2010.png, 1631, 2006, 3637, 151, 0.083035468793, 171, 196, 0, 0
yuba047-2010.png, 2249, 3190, 5439, 291, 0.107004964148, 353, 362, 0, 0
yuba048-2010.png, 2247, 3038, 5285, 200, 0.0756859035005, 237, 246, 0, 0
yuba049-2010.png, 1290, 1726, 3016, 160, 0.106100795756, 192, 201, 0, 0
yuba050-2010.png, 1064, 1794, 2858, 211, 0.147655703289, 241, 250, 0, 0
yuba051-2010.png, 1111, 1444, 2555, 199, 0.155772994129, 221, 239, 0, 0
yuba052-2010.png, 372, 509, 881, 66, 0.149829738933, 73, 84, 0, 0
yuba053-2010.png, 712, 824, 1536, 83, 0.108072916667, 104, 107, 0, 0
yuba054-2010.png, 862, 929, 1791, 129, 0.14405360134, 160, 163, 0, 0
yuba055-2010.png, 1124, 1579, 2703, 139, 0.102848686644, 167, 188, 0, 0
yuba056-2010.png, 1999, 2996, 4995, 391, 0.156556556557, 432, 448, 0, 0
yuba057-2010.png, 1408, 1966, 3374, 133, 0.0788381742739, 163, 173, 0, 0
yuba058-2010.png, 850, 1217, 2067, 93, 0.0899854862119, 117, 117, 0, 0
yuba059-2010.png, 1041, 1588, 2629, 184, 0.139977177634, 206, 227, 0, 0
yuba060-2010.png, 661, 894, 1555, 109, 0.140192926045, 133, 136, 0, 0
yuba061-2010.png, 589, 609, 1198, 121, 0.202003338898, 140, 149, 0, 0
yuba062-2010.png, 1504, 2005, 3509, 155, 0.0883442576233, 198, 205, 0, 0
yuba063-2010.png, 799, 888, 1687, 125, 0.148192056906, 152, 155, 0, 0
yuba064-2010.png, 2444, 3235, 5679, 462, 0.162704701532, 505, 523, 0, 0
